"","this_player","min_age","max_age","num_years","num_teams","pts_prime","max_avg_pts"
"35.36","Alaa Abdelnaby",22,26,4,6,24,"8.2"
"35.39","Zaid Abdul-Aziz",22,31,9,7,25,"13.8"
"35.42","Kareem Abdul-Jabbar",22,41,19,2,24,"34.8"
"35.45","Mahmoud Abdul-Rauf",21,31,10,5,23,"Did Not Play (retired)"
"35.48","Tariq Abdul-Wahad",23,28,5,5,25,"12.2"
"35.52","Shareef Abdur-Rahim",20,31,11,5,22,"23"
"35.55","Tom Abernethy",22,26,4,4,23,"6.8"
"35.58","Forest Able",24,24,0,1,24,"0"
"35.61","John Abramovic",27,28,1,4,27,"11.2"
"35.64","Alex Abrines",23,24,1,1,23,"6"
"35.66","Alex Acker",23,26,3,5,26,"Did Not Play (other pro league—Spain)"
"35.69","Don Ackerman",23,23,0,1,23,"1.5"
"35.72","Mark Acres",25,30,5,5,30,"4.8"
"35.75","Bud Acton",26,26,0,1,26,"3.3"
"35.78","Quincy Acy",22,27,5,6,26,"6.5"
"35.81","Alvan Adams",21,33,12,1,21,"19"
"35.84","Don Adams",23,29,6,7,28,"13.1"
"35.87","George Adams",23,25,2,1,25,"9.3"
"35.90","Hassan Adams",22,24,2,3,22,"Did Not Play (other pro league—Italy)"
"35.93","Jordan Adams",20,21,1,1,21,"3.5"
"35.96","Michael Adams",23,33,10,4,28,"26.5"
"35.99","Steven Adams",20,24,4,1,24,"13.9"
"35.102","Rafael Addison",22,32,10,5,30,"Did Not Play (other pro league—Italy)"
"35.105","Bam Adebayo",20,20,0,1,20,"6.9"
"35.108","Rick Adelman",22,28,6,6,24,"12.6"
"35.111","Jeff Adrien",24,28,4,6,27,"10.9"
"35.114","Arron Afflalo",22,32,10,7,28,"18.2"
"35.117","Maurice Ager",22,26,4,5,26,"Did Not Play (other pro league—Spain, D-League)"
"35.120","Mark Aguirre",22,34,12,4,24,"29.5"
"35.123","Blake Ahearn",23,27,4,5,23,"Did Not Play (other pro league—D-League)"
"35.126","Danny Ainge",22,35,13,5,29,"20.3"
"35.129","Matthew Aitch",23,23,0,1,23,"5.6"
"35.132","Alexis Ajinca",20,28,8,6,26,"Did Not Play"
"35.134","Henry Akin",22,24,2,3,22,"3.8"
"35.137","Josh Akognon",26,26,0,1,26,"1.7"
"35.141","Solomon Alabi",22,23,1,1,23,"2.4"
"35.144","Mark Alarie",23,27,4,2,26,"10.5"
"35.147","Gary Alcorn",23,24,1,2,23,"4"
"35.150","Furkan Aldemir",23,23,0,1,23,"2.3"
"35.152","Cole Aldrich",22,29,7,7,26,"5.5"
"35.155","LaMarcus Aldridge",21,32,11,2,29,"23.4"
"35.158","Chuck Aleksinas",25,25,0,1,25,"5.1"
"35.162","Cliff Alexander",20,20,0,1,20,"1.3"
"35.165","Cory Alexander",22,31,9,8,24,"Did Not Play (other pro league—Italy)"
"35.168","Courtney Alexander",23,25,2,4,23,"17"
"35.172","Gary Alexander",24,24,0,3,24,"2.4"
"35.175","Joe Alexander",22,23,1,2,22,"4.7"
"35.178","Victor Alexander",22,32,10,6,23,"Did Not Play (other pro league—Spain)"
"35.181","Steve Alford",23,26,3,3,24,"6.3"
"35.184","Bill Allen",NA,NA,NA,1,NA,"7.9"
"35.186","Bob Allen",22,22,0,1,22,"1.8"
"35.189","Jarrett Allen",19,19,0,1,19,"8.2"
"35.192","Jerome Allen",23,24,1,4,24,"3.2"
"35.195","Kadeem Allen",25,25,0,1,25,"1.1"
"35.198","Lavoy Allen",22,27,5,3,23,"5.8"
"35.201","Lucius Allen",22,31,9,5,27,"19.5"
"35.204","Malik Allen",23,32,9,9,24,"9.6"
"35.207","Randy Allen",24,25,1,1,25,"3.7"
"35.210","Ray Allen",21,38,17,5,31,"26.4"
"35.213","Tony Allen",23,36,13,3,25,"11.5"
"35.217","Willie Allen",22,22,0,1,22,"1.9"
"35.220","Odis Allison",22,22,0,1,22,"1.9"
"35.223","Lance Allred",26,26,0,1,26,"1"
"35.227","Darrell Allums",22,22,0,1,22,"2.7"
"35.230","Morris Almond",22,26,4,4,23,"Did Not Play (other pro league—Italy, Ukraine)"
"35.233","Derrick Alston",22,24,2,2,23,"6.2"
"35.236","Rafer Alston",23,33,10,7,28,"14.2"
"35.239","Peter Aluma",25,25,0,1,25,"1"
"35.242","John Amaechi",25,32,7,6,29,"Did Not Play (other pro league—United Kingdom, Italy)"
"35.246","Ashraf Amaya",24,25,1,2,24,"6.3"
"35.249","Al-Farouq Aminu",20,27,7,5,25,"10.2"
"35.252","Lou Amundson",24,33,9,12,32,"6"
"35.255","Bob Anderegg",22,22,0,1,22,"4"
"35.258","Chris Andersen",23,38,15,8,26,"Did Not Play (suspended—substance abuse)"
"35.261","David Andersen",29,30,1,4,29,"5.8"
"35.263","Alan Anderson",23,34,11,9,30,"Did Not Play (other pro league—Russia, Croatia)"
"35.266","Andrew Anderson",22,24,2,4,24,"14.3"
"35.269","Antonio Anderson",24,24,0,1,24,"2"
"35.272","Cliff Anderson",23,26,3,5,24,"3.9"
"35.275","Dan Anderson",24,25,1,5,24,"14.7"
"35.278","Dan Anderson",24,25,1,1,25,"4.4"
"35.281","Derek Anderson",23,33,10,8,25,"16.9"
"35.285","Dwight Anderson",22,22,0,1,22,"4.2"
"35.289","Eric Anderson",22,23,1,1,23,"1.9"
"35.292","Greg Anderson",23,33,10,8,24,"Did Not Play (other pro league—Italy)"
"35.295","J.J. Anderson",22,24,2,3,22,"8.9"
"35.298","James Anderson",21,26,5,6,24,"Did Not Play"
"35.301","Jerome Anderson",22,23,1,2,22,"2.8"
"35.304","Justin Anderson",22,24,2,3,23,"8.5"
"35.307","Kenny Anderson",21,34,13,10,23,"18.8"
"35.310","Kim Anderson",23,23,0,1,23,"3"
"35.313","Kyle Anderson",21,24,3,1,24,"7.9"
"35.316","Michael Anderson",22,22,0,1,22,"5.7"
"35.319","Nick Anderson",22,34,12,3,24,"19.9"
"35.322","Richard Anderson",22,29,7,7,23,"Did Not Play (other pro league—Italy)"
"35.325","Ron Anderson",26,35,9,6,30,"16.2"
"35.328","Ryan Anderson",20,29,9,5,25,"19.8"
"35.331","Shandon Anderson",23,32,9,5,26,"12.3"
"35.334","Willie Anderson",22,30,8,5,22,"18.6"
"35.337","Wally Anderzunas",24,24,0,1,24,"3.6"
"35.340","Martynas Andriuskevicius",19,19,0,1,19,"0"
"35.342","Don Anielak",24,24,0,1,24,"3"
"35.345","Ike Anigbogu",19,19,0,1,19,"1.2"
"35.348","Michael Ansley",22,24,2,4,22,"8.7"
"35.351","Chris Anstey",23,25,2,2,25,"6"
"35.353","Giannis Antetokounmpo",19,23,4,1,23,"26.9"
"35.355","Thanasis Antetokounmpo",23,23,0,1,23,"3"
"35.357","Carmelo Anthony",19,33,14,4,22,"28.9"
"35.360","Greg Anthony",24,34,10,7,28,"14"
"35.364","Joel Anthony",25,34,9,5,25,"3.5"
"35.367","Pero Antic",31,32,1,1,31,"7"
"35.369","OG Anunoby",20,20,0,1,20,"5.9"
"35.372","Keith Appling",23,23,0,1,23,"1.2"
"35.375","Rafael Araujo",24,26,2,2,24,"3.3"
"35.378","Stacey Arceneaux",25,25,0,1,25,"7.1"
"35.381","Robert Archibald",22,23,1,5,23,"2"
"35.384","Tiny Archibald",22,35,13,7,24,"Did Not Play (injury—achilles)"
"35.387","Ryan Arcidiacono",23,23,0,1,23,"2"
"35.390","Jim Ard",22,29,7,5,25,"6.4"
"35.393","Gilbert Arenas",20,30,10,5,24,"29.3"
"35.396","Trevor Ariza",19,32,13,7,24,"14.9"
"35.399","Paul Arizin",22,33,11,2,30,"Did Not Play (military service—U.S. Marine Corps)"
"35.402","Joe Arlauckas",22,22,0,1,22,"3.8"
"35.405","B.J. Armstrong",22,32,10,5,26,"14.8"
"35.408","Bob Armstrong",23,23,0,1,23,"1.5"
"35.411","Brandon Armstrong",21,23,2,1,23,"2.7"
"35.414","Curly Armstrong",30,32,2,1,30,"7.3"
"35.417","Darrell Armstrong",26,39,13,6,31,"16.2"
"35.420","Hilton Armstrong",22,29,7,9,24,"Did Not Play"
"35.423","Tate Armstrong",22,23,1,1,22,"4.3"
"35.426","Jesse Arnelle",22,22,0,1,22,"4.7"
"35.429","Jay Arnette",25,27,2,1,25,"3.8"
"35.432","Bob Arnzen",22,26,4,4,23,"Did Not Play"
"35.435","Carlos Arroyo",22,31,9,9,24,"Did Not Play (other pro league—Israel)"
"35.438","Darrell Arthur",20,29,9,3,22,"Did Not Play (injury—achilles)"
"35.441","John Arthurs",22,22,0,1,22,"3.2"
"35.444","Jamel Artis",25,25,0,1,25,"5.1"
"35.447","Omer Asik",24,31,7,4,26,"10.1"
"35.449","Vincent Askew",21,31,10,11,28,"Did Not Play (other pro league—Italy)"
"35.452","Keith Askins",23,31,8,1,28,"6.1"
"35.455","Don Asmonga",25,25,0,1,25,"0.7"
"35.458","Dick Atha",24,26,2,3,24,"Did Not Play"
"35.461","Chucky Atkins",25,35,10,9,30,"13.6"
"35.464","Al Attles",24,34,10,2,25,"11.3"
"35.467","Chet Aubuchon",30,30,0,1,30,"2.2"
"35.470","Stacey Augmon",23,37,14,7,25,"14.8"
"35.473","D.J. Augustin",21,30,9,9,26,"14.9"
"35.476","James Augustine",22,23,1,1,23,"1.6"
"35.479","Isaac Austin",22,32,10,11,28,"Did Not Play (other pro league—Turkey)"
"35.482","Johnny Austin",22,23,1,2,23,"7.7"
"35.485","Ken Austin",22,22,0,1,22,"1.7"
"35.488","Anthony Avent",23,30,7,8,23,"Did Not Play (other pro league—Greece)"
"35.491","Bird Averitt",21,25,4,5,23,"17.9"
"35.494","William Avery",20,22,2,1,21,"2.8"
"35.497","Dennis Awtrey",22,33,11,7,26,"9.9"
"35.500","Gustavo Ayon",26,28,2,5,26,"5.9"
"35.505","Kelenna Azubuike",23,28,5,3,25,"Did Not Play (injury—knee)"
"42.36","Chris Babb",23,23,0,1,23,"1.6"
"42.40","Luke Babbitt",21,28,7,5,26,"7"
"42.43","Milos Babic",22,23,1,2,23,"2"
"42.46","Johnny Bach",24,24,0,1,24,"3.5"
"42.49","Dwayne Bacon",22,22,0,1,22,"3.3"
"42.52","Henry Bacon",24,24,0,1,24,"3.5"
"42.55","Jim Baechtold",25,29,4,2,27,"13.9"
"42.58","Dalibor Bagaric",20,22,2,1,21,"3.7"
"42.60","John Bagley",22,33,11,5,27,"Did Not Play (injury—knee)"
"42.63","Carl Bailey",23,23,0,1,23,"2"
"42.66","Gus Bailey",23,28,5,4,26,"Did Not Play"
"42.69","James Bailey",22,30,8,6,25,"14.1"
"42.72","Thurl Bailey",22,37,15,5,26,"Did Not Play (other pro league—Italy)"
"42.75","Toby Bailey",23,24,1,1,24,"3.5"
"42.78","Cameron Bairstow",24,25,1,1,25,"1.9"
"42.81","Jimmie Baker",22,22,0,1,22,"1.2"
"42.84","LaMark Baker",29,29,0,1,29,"0"
"42.87","Maurice Baker",25,25,0,3,25,"0"
"42.90","Norm Baker",23,23,0,1,23,"0"
"42.92","Ron Baker",23,24,1,1,23,"4.1"
"42.95","Vin Baker",22,34,12,7,24,"21.1"
"42.98","Wade Baldwin",20,21,1,2,21,"5.4"
"42.101","Renaldo Balkman",22,27,5,3,24,"5"
"42.104","Cedric Ball",22,22,0,1,22,"1.1"
"42.107","Lonzo Ball",20,20,0,1,20,"10.2"
"42.110","Greg Ballard",23,34,11,4,27,"Did Not Play"
"42.113","Herschel Baltimore",25,25,0,1,25,"2.4"
"42.116","Gene Banks",22,27,5,2,23,"14.9"
"42.119","Marcus Banks",22,29,7,6,24,"12"
"42.122","Walker Banks",23,23,0,1,23,"2.6"
"42.125","Ken Bannister",24,30,6,4,25,"Did Not Play (other pro league—Israel)"
"42.129","Mike Bantom",22,30,8,6,25,"18.6"
"42.132","John Barber",29,29,0,1,29,"1.4"
"42.135","Leandro Barbosa",21,34,13,6,24,"18.1"
"42.137","Steve Bardo",23,27,4,4,27,"Did Not Play (other pro league—CBA)"
"42.140","J.J. Barea",22,33,11,2,33,"11.6"
"42.143","Andrea Bargnani",21,30,9,3,25,"21.4"
"42.145","Cliff Barker",29,31,2,1,29,"5.7"
"42.148","Tom Barker",21,23,2,6,21,"Did Not Play (other pro league—CBA)"
"42.151","Charles Barkley",21,36,15,3,24,"28.3"
"42.154","Erick Barkley",22,23,1,1,23,"3.1"
"42.157","Don Barksdale",28,31,3,2,29,"13.8"
"42.160","Harrison Barnes",20,25,5,2,24,"19.2"
"42.163","Harry Barnes",23,23,0,1,23,"2"
"42.166","Jim Barnes",23,29,6,6,24,"15.7"
"42.169","Marvin Barnes",22,27,5,6,23,"24.1"
"42.172","Matt Barnes",23,36,13,10,32,"10.3"
"42.175","Dick Barnett",23,37,14,4,29,"Did Not Play (other pro league—ABL)"
"42.178","Jim Barnett",22,32,10,8,26,"18.5"
"42.181","Nathaniel Barnett",23,23,0,1,23,"2.3"
"42.184","John Barnhill",24,33,9,7,24,"11.7"
"42.187","Norton Barnhill",23,23,0,1,23,"1"
"42.190","Leo Barnhorst",25,29,4,5,28,"13.6"
"42.193","John Barr",28,28,0,1,28,"5.1"
"42.196","Mike Barr",22,26,4,3,22,"9.1"
"42.199","Moe Barr",26,26,0,1,26,"2"
"42.202","Andre Barrett",22,25,3,7,22,"5.6"
"42.205","Ernie Barrett",24,26,2,2,26,"Did Not Play (retired)"
"42.208","Mike Barrett",26,29,3,4,26,"Did Not Play"
"42.211","Earl Barron",24,33,9,10,28,"Did Not Play (other pro league—Italy, D-League)"
"42.214","Dana Barros",22,36,14,5,27,"Did Not Play (waived)"
"42.217","Brent Barry",24,37,13,7,30,"14.4"
"42.220","Drew Barry",24,26,2,4,26,"2.8"
"42.223","Jon Barry",23,36,13,9,32,"9"
"42.227","Rick Barry",21,35,14,7,22,"Did Not Play (legal—barred from playing in ABA)"
"42.230","Ed Bartels",24,25,1,4,24,"4.5"
"42.233","Vic Bartolome",23,23,0,1,23,"0.9"
"42.236","Will Barton",22,27,5,3,27,"15.7"
"42.239","Eddie Basden",22,22,0,1,22,"2.1"
"42.242","Jerry Baskerville",24,24,0,1,24,"1.2"
"42.245","Brandon Bass",20,31,11,6,26,"12.5"
"42.248","Tim Bassett",22,28,6,6,25,"9"
"42.251","Maceo Baston",27,33,6,3,31,"Did Not Play (other pro league—Israel)"
"42.254","Mengke Bateer",26,28,2,3,26,"5.1"
"42.256","Billy Ray Bates",23,26,3,4,24,"13.8"
"42.259","Esteban Batista",22,23,1,1,22,"1.8"
"42.261","Mike Batiste",25,25,0,1,25,"6.4"
"42.264","Tony Battie",21,35,14,8,21,"Did Not Play (injury—shoulder)"
"42.267","Shane Battier",23,35,12,4,23,"14.4"
"42.270","John Battle",23,32,9,2,28,"13.6"
"42.273","Kenny Battle",25,28,3,5,26,"6.1"
"42.277","Dave Batton",26,27,1,2,26,"3.3"
"42.280","Lloyd Batts",23,23,0,1,23,"10.3"
"42.283","Nicolas Batum",20,29,9,2,28,"15.1"
"42.285","Johnny Baum",23,27,4,5,27,"8"
"42.288","Frankie Baumholtz",28,28,0,1,28,"14"
"42.291","Lonny Baxter",24,27,3,7,24,"4.8"
"42.294","Jerryd Bayless",20,29,9,8,23,"11.4"
"42.297","Elgin Baylor",24,37,13,2,27,"38.3"
"42.301","Howard Bayne",25,25,0,1,25,"4.9"
"42.304","Aron Baynes",26,31,5,3,28,"6.6"
"42.307","Sergei Bazarevich",29,29,0,1,29,"3"
"42.309","Kent Bazemore",23,28,5,4,24,"13.1"
"42.312","Ed Beach",22,22,0,3,22,"2"
"42.315","Bradley Beal",19,24,5,1,23,"23.1"
"42.318","Al Beard",25,25,0,1,25,"2.5"
"42.321","Butch Beard",22,31,9,7,24,"Did Not Play (military service—U.S. Army)"
"42.324","Ralph Beard",22,23,1,1,23,"16.8"
"42.327","Charles Beasley",22,25,3,4,22,"13.3"
"42.330","Jerome Beasley",23,23,0,1,23,"1"
"42.334","John Beasley",23,29,6,4,23,"19.7"
"42.337","Malik Beasley",20,21,1,1,20,"3.8"
"42.340","Michael Beasley",20,29,9,6,22,"19.2"
"42.343","Zelmo Beaty",23,35,12,5,32,"Did Not Play (legal—barred from playing in ABA)"
"42.346","Rodrigue Beaubois",21,24,3,1,23,"8.9"
"42.348","Byron Beck",23,32,9,3,24,"14.5"
"42.351","Corey Beck",24,27,3,4,26,"Did Not Play (other pro league—CBA)"
"42.355","Ernie Beck",22,29,7,5,26,"Did Not Play (military service—U.S. Navy)"
"42.358","Arthur Becker",26,31,5,6,26,"18.8"
"42.361","Moe Becker",29,29,0,4,29,"6.4"
"42.364","Bob Bedell",23,26,3,3,23,"10.4"
"42.367","William Bedford",23,29,6,4,23,"Did Not Play (rehab—substance abuse)"
"42.370","Hank Beenders",30,32,2,4,30,"12.3"
"42.373","Ron Behagen",23,29,6,10,25,"11.5"
"42.376","Elmer Behnke",22,22,0,1,22,"4"
"42.379","Marco Belinelli",21,31,10,10,31,"13.6"
"42.381","Charlie Bell",22,31,9,7,27,"Did Not Play (other pro league—Spain)"
"42.384","Dennis Bell",22,24,2,1,23,"3"
"42.387","Jordan Bell",23,23,0,1,23,"4.6"
"42.390","Raja Bell",24,35,11,7,29,"14.7"
"42.394","Troy Bell",23,23,0,1,23,"1.8"
"42.397","Whitey Bell",27,28,1,1,27,"5.4"
"42.400","Walt Bellamy",22,35,13,8,22,"31.6"
"42.403","DeAndre' Bembry",22,23,1,1,23,"5.2"
"42.406","Irv Bemoras",23,26,3,3,23,"Did Not Play (military service—U.S. Army)"
"42.409","Leon Benbow",24,25,1,1,25,"7.1"
"42.412","Dragan Bender",19,20,1,1,20,"6.5"
"42.414","Jonathan Bender",19,29,10,3,21,"Did Not Play (injury—knee)"
"42.416","Jerrelle Benimon",23,23,0,1,23,"0"
"42.420","Benoit Benjamin",21,35,14,10,24,"16.4"
"42.423","Corey Benjamin",20,24,4,3,21,"Did Not Play (other pro league—ABA, Italy)"
"42.426","Anthony Bennett",20,23,3,4,21,"5.2"
"42.429","Elmer Bennett",24,26,2,5,24,"3.8"
"42.432","Mario Bennett",22,26,4,5,22,"Did Not Play (other pro league—CBA)"
"42.435","Mel Bennett",21,27,6,6,21,"Did Not Play (other pro league—WBA)"
"42.438","Spider Bennett",25,25,0,3,25,"7.7"
"42.441","Tony Bennett",23,25,2,1,25,"4.7"
"42.444","Winston Bennett",24,26,2,3,24,"6.1"
"42.447","David Benoit",23,32,9,7,26,"Did Not Play (other pro league—Israel)"
"42.450","Keith Benson",23,23,0,1,23,"0"
"42.453","Kent Benson",23,33,10,5,26,"15.7"
"42.456","Ben Bentil",21,21,0,1,21,"0"
"42.459","Gene Berce",23,23,0,1,23,"3.3"
"42.462","Gary Bergen",24,24,0,1,24,"1.3"
"42.465","Larry Bergh",24,24,0,1,24,"6.1"
"42.468","Ricky Berry",24,24,0,1,24,"11"
"42.472","Walter Berry",22,24,2,5,22,"17.6"
"42.475","Davis Bertans",24,25,1,1,25,"5.9"
"42.477","Del Beshore",22,23,1,2,23,"3.6"
"42.480","Travis Best",23,32,9,6,28,"11.9"
"42.483","Patrick Beverley",24,29,5,2,29,"12.2"
"42.486","Sim Bhullar",22,22,0,1,22,"0.7"
"42.489","Wesley Bialosuknia",22,22,0,1,22,"8.7"
"42.492","Al Bianchi",24,33,9,2,29,"10.3"
"42.495","Hank Biasatti",25,25,0,1,25,"1"
"42.498","Henry Bibby",23,31,8,5,29,"12.2"
"42.501","Mike Bibby",20,33,13,7,27,"21.1"
"42.504","Ed Biedenbach",23,23,0,1,23,"0.6"
"42.507","Andris Biedrins",18,27,9,2,22,"11.9"
"42.509","Don Bielke",NA,NA,NA,1,NA,"2"
"42.511","Bob Bigelow",22,25,3,4,23,"2.9"
"42.514","Lionel Billingy",22,22,0,1,22,"8.5"
"42.517","Chauncey Billups",21,37,16,8,33,"19.5"
"42.520","Dave Bing",23,34,11,3,24,"27.1"
"42.523","Joe Binion",25,25,0,1,25,"1.3"
"42.526","Khem Birch",25,25,0,1,25,"4.2"
"42.530","Jabari Bird",23,23,0,1,23,"3"
"42.533","Jerry Bird",23,23,0,1,23,"2.3"
"42.536","Larry Bird",23,35,12,1,31,"29.9"
"42.539","Otis Birdsong",22,33,11,3,25,"24.6"
"42.542","Gale Bishop",26,26,0,1,26,"8.3"
"42.545","Bismack Biyombo",19,25,6,4,24,"6"
"42.547","Nemanja Bjelica",27,29,2,1,29,"6.8"
"42.549","Uwe Blab",23,27,4,4,23,"2.6"
"42.552","Charlie Black",27,30,3,6,27,"Did Not Play (other pro league—NPBL)"
"42.555","Norman Black",23,23,0,1,23,"2.7"
"42.558","Tarik Black",23,26,3,3,23,"7.2"
"42.562","Tom Black",29,29,0,3,29,"5"
"42.565","Rolando Blackman",22,34,12,2,24,"22.4"
"42.568","Alex Blackwell",22,22,0,1,22,"1.3"
"42.571","Cory Blackwell",21,21,0,1,21,"3.4"
"42.574","James Blackwell",26,26,0,3,26,"1.6"
"42.577","Nate Blackwell",22,22,0,1,22,"3.7"
"42.580","DeJuan Blair",20,26,6,3,22,"9.5"
"42.583","Steve Blake",23,35,12,9,28,"11"
"42.586","Antonio Blakeney",21,21,0,1,21,"7.9"
"42.589","Will Blalock",23,23,0,1,23,"1.8"
"42.592","George Blaney",22,22,0,1,22,"3.3"
"42.595","Lance Blanks",24,26,2,2,26,"2.6"
"42.599","Ricky Blanton",26,26,0,1,26,"3"
"42.602","Andray Blatche",19,27,8,2,24,"16.8"
"42.604","Mookie Blaylock",22,34,12,3,29,"17.4"
"42.608","Eric Bledsoe",21,28,7,4,27,"21.1"
"42.611","Leon Blevins",24,24,0,1,24,"1"
"42.614","John Block",22,31,9,8,23,"20.2"
"42.617","Mike Bloom",33,34,1,5,33,"11.1"
"42.620","Corie Blount",25,35,10,8,32,"6.8"
"42.623","Mark Blount",25,33,8,5,30,"12.4"
"42.626","Vander Blue",21,25,4,3,22,"Did Not Play"
"42.629","Ray Blume",23,23,0,1,23,"4.6"
"42.632","Nelson Bobb",25,28,3,1,28,"6.2"
"42.635","Tony Bobbitt",25,25,0,1,25,"2.5"
"42.638","Bucky Bockhorn",25,31,6,1,28,"15.8"
"42.641","Tom Boerwinkle",23,32,9,1,25,"10.8"
"42.644","Keith Bogans",23,33,10,10,24,"9.6"
"42.647","Bogdan Bogdanovic",25,25,0,1,25,"11.8"
"42.649","Bojan Bogdanovic",25,28,3,4,28,"14.3"
"42.651","Muggsy Bogues",23,36,13,5,30,"11.1"
"42.654","Andrew Bogut",21,33,12,6,25,"15.9"
"42.657","Etdrick Bohannon",24,27,3,6,26,"2.4"
"42.662","Manute Bol",23,32,9,5,26,"3.9"
"42.665","Bill Bolger",22,22,0,1,22,"2.8"
"42.668","Joel Bolomboy",23,24,1,2,23,"1.8"
"42.671","Doug Bolstorff",26,26,0,1,26,"1.3"
"42.674","George Bon Salle",26,26,0,1,26,"1.3"
"42.677","Phil Bond",23,23,0,1,23,"0.6"
"42.680","Walter Bond",23,25,2,4,23,"8"
"42.683","Dexter Boney",26,26,0,1,26,"2.4"
"42.686","Ron Bonham",22,25,3,3,22,"Did Not Play"
"42.689","Anthony Bonner",22,27,5,3,23,"9.4"
"42.692","Matt Bonner",24,35,11,2,28,"8.2"
"42.695","Butch Booker",24,24,0,1,24,"5.8"
"42.698","Devin Booker",19,21,2,1,21,"24.9"
"42.701","Melvin Booker",23,24,1,4,24,"7.3"
"42.704","Trevor Booker",23,30,7,6,30,"10.1"
"42.707","Josh Boone",22,25,3,1,23,"8.2"
"42.710","Ron Boone",22,34,12,8,29,"26.2"
"42.713","Calvin Booth",23,32,9,8,24,"7.5"
"42.716","Keith Booth",23,24,1,1,24,"3.1"
"42.719","Bob Boozer",23,33,10,7,31,"21.7"
"42.722","Carlos Boozer",21,33,12,4,26,"21.1"
"42.725","Curtis Borchardt",23,24,1,1,23,"3.6"
"42.728","Jake Bornheimer",21,22,1,1,21,"5.9"
"42.731","Lazaro Borrell",27,27,0,1,27,"3.6"
"42.733","Ike Borsavage",26,26,0,1,26,"2.7"
"42.736","Vince Boryla",22,26,4,1,23,"14.9"
"42.739","Chris Bosh",19,31,12,2,25,"24"
"42.742","Jim Bostic",25,25,0,1,25,"6.5"
"42.745","Lawrence Boston",23,23,0,1,23,"4.3"
"42.748","Tom Boswell",22,30,8,6,26,"Did Not Play (other pro league—Italy)"
"42.752","Chris Boucher",25,25,0,1,25,"0"
"42.755","Ruben Boumtje-Boumtje",23,25,2,1,23,"1.2"
"42.758","Don Boven",24,27,3,6,24,"Did Not Play (other pro league—NPBL)"
"42.761","Cal Bowdler",22,24,2,1,23,"3.2"
"42.764","Bruce Bowen",25,37,12,5,33,"8.2"
"42.767","Ryan Bowen",24,34,10,5,26,"Did Not Play (other pro league—Spain, Israel)"
"42.770","Tommie Bowens",27,29,2,3,27,"6.1"
"42.773","Anthony Bowie",25,34,9,5,28,"Did Not Play (other pro league—Italy)"
"42.776","Sam Bowie",23,33,10,4,25,"Did Not Play (injury—leg)"
"42.779","Orbie Bowling",28,28,0,1,28,"1.9"
"42.782","Ira Bowman",26,28,2,2,28,"3.3"
"42.786","Nate Bowman",23,28,5,4,27,"3.1"
"42.789","Donnie Boyce",22,23,1,1,22,"3"
"42.792","Dennis Boyd",24,24,0,1,24,"1.2"
"42.795","Freddie Boyd",22,27,5,3,22,"10.5"
"42.798","Ken Boyd",22,22,0,1,22,"3.2"
"42.801","Earl Boykins",22,35,13,12,30,"Did Not Play"
"42.804","Harry Boykoff",27,28,1,4,27,"12.8"
"42.807","Winford Boynes",21,23,2,2,21,"9.3"
"42.810","Cedric Bozeman",23,23,0,1,23,"1.1"
"42.813","Steve Bracey",22,24,2,2,23,"7.3"
"42.816","Craig Brackins",23,24,1,1,23,"2.7"
"42.819","Gary Bradds",22,28,6,7,26,"Did Not Play"
"42.822","Alex Bradley",22,22,0,1,22,"3.5"
"42.825","Alonzo Bradley",24,26,2,1,24,"7"
"42.828","Avery Bradley",20,27,7,4,26,"16.3"
"42.831","Bill Bradley",26,26,0,1,26,"3.8"
"42.833","Bill Bradley",24,33,9,1,29,"16.1"
"42.836","Charles Bradley",22,24,2,2,23,"3.6"
"42.839","Dudley Bradley",22,31,9,9,22,"Did Not Play (other pro league—CBA)"
"42.842","Jim Bradley",21,23,2,2,21,"8.3"
"42.845","Joe Bradley",21,21,0,1,21,"1.9"
"42.848","Michael Bradley",22,26,4,6,23,"5"
"42.852","Shawn Bradley",21,32,11,4,24,"14.6"
"42.855","Tony Bradley",20,20,0,1,20,"0.9"
"42.858","Mark Bradtke",28,28,0,1,28,"1.6"
"42.860","Marques Bragg",25,25,0,1,25,"2.5"
"42.863","Torraye Braggs",27,28,1,3,27,"3.1"
"42.866","A.J. Bramlett",23,23,0,1,23,"1"
"42.869","Adrian Branch",23,26,3,4,25,"7.4"
"42.872","Elton Brand",20,36,16,5,26,"24.7"
"42.875","Terrell Brandon",21,31,10,4,26,"19.5"
"42.878","Bob Brannum",24,29,5,3,24,"Did Not Play (other pro league—NPBL)"
"42.881","Brad Branson",23,24,1,2,24,"5.5"
"42.884","Jesse Branson",24,26,2,3,26,"Did Not Play"
"42.887","Jim Brasco",21,21,0,3,21,"4.4"
"42.890","Mike Bratz",22,30,8,6,25,"10"
"42.893","Carl Braun",20,34,14,3,30,"Did Not Play (military service—U.S. Army)"
"42.896","Tim Breaux",24,27,3,3,24,"Did Not Play (other pro league—CBA)"
"42.899","J.R. Bremer",22,23,1,4,22,"8.3"
"42.902","Pete Brennan",22,22,0,1,22,"2.5"
"42.905","Tom Brennan",24,24,0,1,24,"0.9"
"42.908","Randy Breuer",23,33,10,5,27,"12"
"42.911","Corey Brewer",21,31,10,7,23,"13"
"42.914","Jamison Brewer",21,24,3,2,23,"2.5"
"42.917","Jim Brewer",22,30,8,5,24,"11.5"
"42.920","Ron Brewer",23,30,7,7,26,"19.4"
"42.923","Ronnie Brewer",21,28,7,7,23,"13.7"
"42.926","Primoz Brezec",22,30,8,8,25,"Did Not Play"
"42.928","Frankie Brian",26,32,6,3,26,"17.8"
"42.931","Frank Brickowski",25,37,12,8,33,"Did Not Play (injury—shoulder)"
"42.934","Junior Bridgeman",22,33,11,2,26,"17.6"
"42.937","Bill Bridges",23,35,12,6,27,"17.4"
"42.940","Al Brightman",23,23,0,1,23,"9.8"
"42.943","Aud Brindley",23,23,0,1,23,"2.8"
"42.946","John Brisker",22,27,5,3,23,"29.3"
"42.949","Allan Bristow",22,31,9,5,28,"11.6"
"42.952","Tyrone Britt",23,23,0,1,23,"2.5"
"42.955","Wayman Britt",25,25,0,1,25,"1.3"
"42.958","Mike Brittain",22,23,1,1,22,"1.7"
"42.961","Dave Britton",22,22,0,1,22,"2"
"42.964","Jon Brockman",22,24,2,2,22,"2.8"
"42.967","Jim Brogan",23,24,1,1,23,"6.3"
"42.970","Malcolm Brogdon",24,25,1,1,25,"13"
"42.973","Gary Brokaw",21,24,3,4,23,"8.9"
"42.976","Price Brookfield",28,29,1,2,28,"8.2"
"42.979","Clarence Brookins",NA,NA,NA,1,NA,"2.6"
"42.981","Aaron Brooks",23,33,10,9,25,"Did Not Play (other pro league—China)"
"42.984","Dillon Brooks",22,22,0,1,22,"11"
"42.987","Kevin Brooks",22,24,2,1,23,"4.1"
"42.990","MarShon Brooks",23,29,6,8,29,"Did Not Play"
"42.993","Michael Brooks",22,29,7,4,23,"Did Not Play (injury—knee)"
"42.996","Scott Brooks",23,32,9,7,29,"7.9"
"42.1000","Andre Brown",25,27,2,3,26,"3"
"42.1003","Anthony Brown",23,25,2,5,24,"4.5"
"42.1006","Bob Brown",25,26,1,2,26,"11.7"
"42.1009","Bobby Brown",24,33,9,9,25,"Did Not Play (other pro league)"
"42.1012","Chucky Brown",21,33,12,13,27,"8.6"
"42.1015","Damone Brown",22,25,3,4,23,"5.6"
"42.1018","Darrell Brown",25,25,0,1,25,"1.3"
"42.1021","Dee Brown",22,33,11,4,26,"15.6"
"42.1024","Dee Brown",22,24,2,5,24,"Did Not Play"
"42.1027","Derrick Brown",22,24,2,3,24,"8.1"
"42.1030","Devin Brown",24,31,7,8,28,"11.6"
"42.1033","Ernest Brown",22,22,0,1,22,"1"
"42.1036","Fred Brown",23,35,12,1,27,"23.1"
"42.1039","George Brown",22,22,0,1,22,"1"
"42.1042","Gerald Brown",23,23,0,1,23,"2.4"
"42.1045","Harold Brown",23,23,0,1,23,"4.9"
"42.1048","Jabari Brown",22,22,0,1,22,"11.9"
"42.1052","Jaylen Brown",20,21,1,1,21,"14.5"
"42.1055","John Brown",22,28,6,4,23,"11.2"
"42.1058","Kedrick Brown",20,23,3,4,22,"5.3"
"42.1061","Kwame Brown",19,30,11,8,21,"10.9"
"42.1063","Larry Brown",27,31,4,6,29,"13.7"
"42.1066","Leon Brown",27,27,0,1,27,"0"
"42.1069","Lewis Brown",25,25,0,1,25,"1"
"42.1072","Lorenzo Brown",23,27,4,5,24,"Did Not Play"
"42.1075","Marcus Brown",22,25,3,4,22,"Did Not Play (other pro league—France)"
"42.1078","Markel Brown",23,26,3,3,24,"Did Not Play"
"42.1081","Mike Brown",23,33,10,5,28,"7.7"
"42.1084","Myron Brown",22,22,0,1,22,"2.3"
"42.1087","P.J. Brown",24,38,14,7,29,"11.4"
"42.1090","Randy Brown",23,34,11,4,30,"8.8"
"42.1094","Raymond Brown",24,24,0,1,24,"1"
"42.1098","Rickey Brown",22,26,4,3,23,"5.7"
"42.1101","Roger Brown",25,32,7,4,27,"23"
"42.1104","Roger Brown",22,29,7,9,23,"Did Not Play"
"42.1107","Shannon Brown",21,29,8,9,26,"11"
"42.1110","Stan Brown",18,22,4,3,22,"Did Not Play (other pro league—EBL)"
"42.1112","Sterling Brown",22,22,0,1,22,"4"
"42.1115","Tierre Brown",22,25,3,4,25,"4.4"
"42.1118","Tony Brown",24,31,7,11,26,"Did Not Play (injury—foot)"
"42.1121","Jim Browne",19,20,1,2,20,"1.5"
"42.1123","Stanley Brundy",22,22,0,1,22,"2.3"
"42.1126","Brian Brunkhorst",23,23,0,1,23,"8.3"
"42.1129","George Bruns",26,26,0,1,26,"6.6"
"42.1132","Rick Brunson",25,33,8,9,32,"5.5"
"42.1135","Nicolas Brussino",23,24,1,2,23,"2.8"
"42.1137","Em Bryant",26,33,7,3,32,"10"
"42.1140","Joe Bryant",21,28,7,3,27,"11.8"
"42.1143","Kobe Bryant",18,37,19,1,27,"35.4"
"42.1145","Mark Bryant",23,37,14,11,31,"9.3"
"42.1148","Thomas Bryant",20,20,0,1,20,"1.5"
"42.1151","Wallace Bryant",24,26,2,4,24,"4.1"
"42.1154","Torgeir Bryn",25,25,0,1,25,"1.3"
"42.1157","George Bucci",22,22,0,1,22,"3.9"
"42.1160","Joe Buckhalter",24,25,1,1,24,"5.9"
"42.1163","Steve Bucknall",23,23,0,1,23,"1.3"
"42.1166","Cleveland Buckner",23,24,1,1,23,"6.4"
"42.1169","Greg Buckner",23,32,9,5,29,"6.7"
"42.1172","Quinn Buckner",22,31,9,3,26,"13.3"
"42.1175","Dave Budd",22,26,4,1,24,"9.5"
"42.1178","Chase Budinger",21,27,6,5,22,"9.8"
"42.1181","Walt Budko",23,26,3,2,23,"11.5"
"42.1184","Jud Buechler",22,33,11,8,24,"6.2"
"42.1187","Rodney Buford",22,27,5,6,24,"Did Not Play (other pro league—Greece)"
"42.1190","Matt Bullard",23,34,11,4,25,"Did Not Play (other pro league—Greece)"
"42.1194","Reggie Bullock",22,26,4,4,26,"11.3"
"42.1197","Larry Bunce",22,23,1,5,22,"12.1"
"42.1200","Greg Bunch",22,22,0,1,22,"2.3"
"42.1203","Dick Bunt",22,22,0,3,22,"4.3"
"42.1206","Bill Buntin",23,23,0,1,23,"7.7"
"42.1209","Bill Bunting",22,24,2,4,23,"4.9"
"42.1212","Ticky Burden",22,24,2,2,22,"19.9"
"42.1215","Pat Burke",29,33,4,3,29,"Did Not Play (other pro league—Spain)"
"42.1218","Trey Burke",21,25,4,3,21,"12.8"
"42.1221","Roger Burkman",23,23,0,1,23,"0.8"
"42.1224","Alec Burks",20,26,6,1,22,"14"
"42.1227","Antonio Burks",24,25,1,1,24,"3"
"42.1230","Kevin Burleson",26,26,0,1,26,"1.8"
"42.1233","Tom Burleson",22,28,6,3,23,"15.6"
"42.1236","Jack Burmaster",23,23,0,1,23,"9.8"
"42.1239","David Burns",23,23,0,3,23,"2.7"
"42.1242","Evers Burns",22,22,0,1,22,"2.4"
"42.1245","Jim Burns",22,22,0,3,22,"4.7"
"42.1248","Scott Burrell",23,30,7,5,25,"13.2"
"42.1251","Art Burris",26,27,1,3,27,"5.6"
"42.1254","Junior Burrough",23,23,0,1,23,"3.1"
"42.1257","Bob Burrow",22,23,1,2,22,"6"
"42.1260","Ed Burton",22,25,3,3,25,"Did Not Play (other pro league—MPBL)"
"42.1263","Willie Burton",22,30,8,6,26,"Did Not Play (other pro league—CBA, Italy)"
"42.1266","Steve Burtt",22,30,8,6,25,"Did Not Play (other pro league—CBA)"
"42.1269","Don Buse",22,34,12,5,25,"12.5"
"42.1272","David Bustion",23,23,0,1,23,"3.4"
"42.1275","Donnie Butcher",25,29,4,3,27,"8.6"
"42.1278","Al Butler",23,26,3,4,23,"14.7"
"42.1281","Caron Butler",22,35,13,10,28,"20.8"
"42.1284","Greg Butler",22,24,2,2,22,"1.7"
"42.1287","Jackie Butler",19,21,2,2,20,"5.3"
"42.1289","Jimmy Butler",22,28,6,2,27,"23.9"
"42.1292","Mike Butler",22,25,3,2,24,"10.2"
"42.1295","Mitchell Butler",23,33,10,7,24,"Did Not Play (other pro league—Lithuania)"
"42.1298","Rasual Butler",23,36,13,11,30,"Did Not Play"
"42.1301","Dwight Buycks",24,28,4,4,25,"Did Not Play"
"42.1304","Derrick Byars",27,27,0,1,27,"5"
"42.1308","Andrew Bynum",18,26,8,5,24,"Did Not Play (injury—knee)"
"42.1310","Will Bynum",23,32,9,4,27,"Did Not Play (other pro league—Israel)"
"42.1314","Walter Byrd",NA,NA,NA,1,NA,"1.5"
"42.1316","Marty Byrnes",22,26,4,7,24,"Did Not Play (other pro league—CBA)"
"42.1319","Tommy Byrnes",23,27,4,6,25,"9.6"
"42.1322","Michael Bytzura",24,24,0,1,24,"3.5"
"49.36","Zarko Cabarkapa",22,24,2,3,23,"6.2"
"49.38","Barney Cable",23,28,5,7,26,"13.7"
"49.41","Bruno Caboclo",19,22,3,3,22,"2.6"
"49.43","Jason Caffey",22,29,7,4,26,"12"
"49.46","Michael Cage",23,38,15,6,25,"Did Not Play (retired)"
"49.49","Gerry Calabrese",25,26,1,1,26,"5"
"49.52","Nick Calathes",24,25,1,1,24,"4.9"
"49.55","Jose Calderon",24,36,12,8,27,"12.8"
"49.57","Adrian Caldwell",23,31,8,8,30,"Did Not Play (other pro league—Italy)"
"49.61","Jim Caldwell",25,26,1,4,25,"8.4"
"49.64","Joe Caldwell",23,33,10,6,29,"23.3"
"49.67","Kentavious Caldwell-Pope",20,24,4,2,22,"14.5"
"49.70","Bill Calhoun",21,27,6,5,25,"10.3"
"49.73","Corky Calhoun",22,29,7,5,23,"8.2"
"49.76","Demetrius Calip",22,22,0,1,22,"1.6"
"49.79","Tom Callahan",25,25,0,1,25,"1.3"
"49.82","Rick Calloway",24,24,0,1,24,"3.2"
"49.86","Ernie Calverley",23,25,2,1,23,"14.3"
"49.89","Mack Calvin",22,33,11,12,23,"Did Not Play (dropped from roster)"
"49.92","Dexter Cambridge",23,23,0,1,23,"7"
"49.95","Marcus Camby",22,38,16,7,22,"14.8"
"49.98","Elden Campbell",22,36,14,7,30,"15.3"
"49.101","Tony Campbell",22,32,10,7,27,"23.2"
"49.104","Isaiah Canaan",22,26,4,5,23,"12.6"
"49.107","Larry Cannon",22,26,4,7,23,"Did Not Play"
"49.110","Clint Capela",20,23,3,1,23,"13.9"
"49.112","Derrick Caracter",22,22,0,1,22,"2"
"49.116","Frank Card",24,28,4,6,26,"12.4"
"49.119","Brian Cardinal",23,34,11,6,26,"9.6"
"49.122","Howie Carl",23,23,0,1,23,"5.5"
"49.125","Chet Carlisle",30,30,0,1,30,"5"
"49.128","Geno Carlisle",28,28,0,1,28,"1.3"
"49.132","Rick Carlisle",25,30,5,4,28,"Did Not Play (injury—shoulder)"
"49.136","Don Carlos",24,24,0,1,24,"11.2"
"49.139","Al Carlson",24,24,0,1,24,"2.6"
"49.142","Don Carlson",27,31,4,4,27,"Did Not Play (other pro league—NBL)"
"49.145","Bob Carney",22,22,0,1,22,"3.6"
"49.148","Rodney Carney",22,26,4,5,24,"7.2"
"49.151","Bob Carpenter",32,33,1,3,32,"9.3"
"49.154","Antoine Carr",23,38,15,7,29,"20.1"
"49.157","Austin Carr",23,32,9,4,25,"21.9"
"49.160","Chris Carr",21,26,5,7,23,"9.9"
"49.163","Cory Carr",23,23,0,1,23,"4.1"
"49.166","Kenny Carr",22,31,9,5,28,"15.6"
"49.169","M.L. Carr",25,34,9,3,28,"18.7"
"49.172","Darel Carrier",27,32,5,2,28,"23.2"
"49.175","Bob Carrington",24,26,2,5,24,"Did Not Play"
"49.178","DeMarre Carroll",23,31,8,8,31,"13.5"
"49.182","Joe Barry Carroll",22,32,10,7,24,"Did Not Play (other pro league—Italy)"
"49.185","Matt Carroll",23,32,9,5,26,"12.1"
"49.188","Jimmy Carruth",27,27,0,1,27,"1.3"
"49.191","Anthony Carter",24,36,12,7,32,"7.8"
"49.194","Butch Carter",22,27,5,5,25,"13.4"
"49.197","Fred Carter",24,31,7,4,29,"21.9"
"49.200","George Carter",24,32,8,10,28,"Did Not Play"
"49.203","Howard Carter",22,23,1,2,22,"6.2"
"49.206","Jake Carter",25,25,0,3,25,"3.5"
"49.209","Maurice Carter",27,27,0,3,27,"5.5"
"49.212","Reggie Carter",23,24,1,1,24,"4"
"49.216","Ron Carter",22,23,1,2,22,"3.1"
"49.219","Vince Carter",22,41,19,8,24,"27.6"
"49.222","Michael Carter-Williams",22,26,4,5,22,"16.7"
"49.225","Bill Cartwright",22,37,15,4,22,"Did Not Play (injury—foot)"
"49.228","Jay Carty",27,27,0,1,27,"2.7"
"49.231","Alex Caruso",23,23,0,1,23,"3.6"
"49.234","Cornelius Cash",24,24,0,1,24,"3.5"
"49.237","Sam Cash",22,22,0,1,22,"2.9"
"49.240","Sam Cassell",24,38,14,9,34,"19.8"
"49.243","Omri Casspi",21,29,8,7,28,"12"
"49.245","Harvey Catchings",23,33,10,5,27,"6.1"
"49.248","Terry Catledge",22,29,7,3,26,"19.4"
"49.251","Sid Catlett",23,23,0,1,23,"0.7"
"49.254","Kelvin Cato",23,32,9,6,25,"8.7"
"49.258","Bobby Cattage",23,27,4,3,27,"Did Not Play (other pro league—CBA)"
"49.261","Willie Cauley-Stein",22,24,2,1,24,"12.8"
"49.264","Duane Causwell",22,32,10,2,24,"8.2"
"49.267","Tyler Cavanaugh",23,23,0,1,23,"4.7"
"49.270","Ron Cavenall",25,29,4,4,25,"Did Not Play (other pro league—CBA)"
"49.273","Cedric Ceballos",21,31,10,6,25,"21.7"
"49.276","John Celestand",22,22,0,1,22,"2.3"
"49.279","Al Cervi",32,35,3,1,32,"10.2"
"49.281","Lionel Chalmers",24,24,0,1,24,"3.1"
"49.284","Mario Chalmers",22,31,9,4,29,"Did Not Play"
"49.287","Bill Chamberlain",23,24,1,4,23,"5.5"
"49.290","Wilt Chamberlain",23,36,13,5,25,"50.4"
"49.293","Jerry Chambers",23,30,7,7,29,"Did Not Play (military service)"
"49.296","Tom Chambers",22,38,16,7,30,"Did Not Play (other pro league—Israel)"
"49.299","Mike Champion",24,24,0,1,24,"0"
"49.302","Tyson Chandler",19,35,16,7,25,"11.8"
"49.304","Wilson Chandler",20,30,10,4,23,"Did Not Play"
"49.307","Don Chaney",22,33,11,4,26,"13.1"
"49.310","John Chaney",29,29,0,3,29,"4.7"
"49.313","Rex Chapman",21,32,11,5,26,"18.2"
"49.316","Wayne Chapman",23,26,3,4,25,"10"
"49.319","Len Chappell",22,31,9,11,23,"17.3"
"49.322","Ken Charles",22,26,4,2,25,"11.1"
"49.325","Lorenzo Charles",22,22,0,1,22,"3.4"
"49.328","Calbert Cheaney",22,34,12,6,23,"16.6"
"49.331","Maurice Cheeks",22,36,14,6,30,"15.6"
"49.334","Phil Chenier",21,30,9,6,23,"21.9"
"49.337","Will Cherry",23,23,0,1,23,"1.9"
"49.340","Derrick Chievous",21,23,2,3,21,"9.3"
"49.343","Pete Chilcutt",23,31,8,8,25,"7.3"
"49.346","Josh Childress",21,30,9,5,23,"Did Not Play (other pro league—Greece)"
"49.349","Randolph Childress",23,24,1,3,23,"3"
"49.352","Chris Childs",27,35,8,4,28,"12.8"
"49.355","Leroy Chollet",24,25,1,1,24,"3.2"
"49.358","Jim Chones",23,32,9,5,26,"15.8"
"49.361","Marquese Chriss",19,20,1,1,19,"9.2"
"49.364","Fred Christ",24,24,0,1,24,"3.3"
"49.367","Cal Christensen",23,27,4,3,23,"6.6"
"49.370","Bob Christian",23,27,4,5,27,"4.8"
"49.373","Doug Christie",22,36,14,8,27,"16.5"
"49.376","Dionte Christmas",27,27,0,1,27,"2.3"
"49.379","Rakeem Christmas",24,25,1,1,24,"4"
"49.382","Semaj Christon",24,24,0,1,24,"2.9"
"49.385","Patrick Christopher",26,26,0,1,26,"1.5"
"49.388","Stephen Chubin",23,25,2,8,23,"18.2"
"49.391","Robert Churchwell",23,23,0,1,23,"1.5"
"49.394","Archie Clark",25,34,9,7,30,"29"
"49.397","Carlos Clark",23,24,1,1,24,"2.7"
"49.400","Earl Clark",22,27,5,7,25,"7.3"
"49.403","Ian Clark",22,26,4,5,26,"7.4"
"49.406","Keon Clark",23,28,5,5,26,"11.3"
"49.409","Richard Clark",24,25,1,2,25,"6.8"
"49.412","Coty Clarke",23,23,0,1,23,"2"
"49.415","Jordan Clarkson",22,25,3,3,23,"15.5"
"49.419","Gian Clavell",24,24,0,1,24,"2.9"
"49.422","Victor Claver",24,26,2,1,24,"3.8"
"49.424","John Clawson",24,24,0,1,24,"4.7"
"49.427","Charles Claxton",25,25,0,1,25,"0.7"
"49.430","Speedy Claxton",23,30,7,8,26,"Did Not Play (injury—knee)"
"49.433","Jim Cleamons",22,30,8,5,26,"12.2"
"49.436","Mateen Cleaves",23,28,5,4,23,"5.4"
"49.439","Barry Clemens",22,32,10,5,24,"9.3"
"49.442","Antonius Cleveland",23,23,0,3,23,"3.3"
"49.445","Nat Clifton",28,35,7,2,32,"13.1"
"49.448","Bill Closs",28,30,2,3,28,"11.8"
"49.451","Keith Closs",21,23,2,1,23,"4.2"
"49.454","Paul Cloyd",29,29,0,3,29,"3.5"
"49.457","Bob Cluggish",29,29,0,1,29,"4.4"
"49.460","Ben Clyde",23,23,0,1,23,"2.8"
"49.463","Richard Coffey",25,25,0,1,25,"1.3"
"49.466","Fred Cofield",24,25,1,2,24,"3.7"
"49.470","John Coker",24,29,5,6,27,"Did Not Play (other pro league—Spain)"
"49.473","Norris Cole",23,28,5,4,27,"10.6"
"49.476","Ben Coleman",25,32,7,6,26,"Did Not Play (other pro league—Spain)"
"49.480","Derrick Coleman",23,37,14,4,25,"20.7"
"49.483","E.C. Coleman",23,28,5,3,26,"8.6"
"49.486","Jack Coleman",25,33,8,3,31,"14.1"
"49.489","Norris Coleman",26,26,0,1,26,"5.3"
"49.492","Bimbo Coles",22,35,13,6,27,"12.8"
"49.495","Jason Collier",23,27,4,2,26,"11.3"
"49.499","Art Collins",26,26,0,1,26,"3.2"
"49.502","Don Collins",22,28,6,6,22,"Did Not Play (other pro league—CBA)"
"49.505","Doug Collins",22,29,7,1,24,"20.8"
"49.508","James Collins",24,24,0,1,24,"2.6"
"49.511","Jarron Collins",23,32,9,5,23,"6.4"
"49.514","Jason Collins",23,35,12,8,26,"6.4"
"49.517","Jimmy Collins",24,25,1,1,24,"4"
"49.520","John Collins",20,20,0,1,20,"10.5"
"49.523","Mardy Collins",22,25,3,3,24,"5.9"
"49.526","Sherron Collins",23,23,0,1,23,"0.9"
"49.529","Zach Collins",20,20,0,1,20,"4.4"
"49.532","Kyle Collinsworth",26,26,0,1,26,"3.2"
"49.535","Darren Collison",22,30,8,5,27,"16.1"
"49.538","Nick Collison",24,37,13,2,27,"9.8"
"49.541","Joe Colone",25,25,0,1,25,"5.5"
"49.544","Sean Colson",25,25,0,3,25,"1.5"
"49.548","Steve Colter",22,32,10,9,23,"Did Not Play (other pro league—Croatia)"
"49.551","Glen Combs",22,28,6,6,23,"22.2"
"49.554","Leroy Combs",23,23,0,1,23,"4.5"
"49.557","John Comeaux",24,24,0,1,24,"3.3"
"49.560","Dallas Comegys",23,24,1,2,24,"6.5"
"49.563","Larry Comley",24,24,0,1,24,"2.1"
"49.566","Jeffrey Congdon",24,28,4,6,26,"9.8"
"49.569","Gene Conley",22,33,11,4,32,"Did Not Play (major league baseball—Milwaukee Braves)"
"49.572","Larry Conley",24,24,0,1,24,"2"
"49.575","Mike Conley",20,30,10,1,29,"20.5"
"49.578","Ed Conlin",22,28,6,4,24,"15"
"49.581","Marty Conlon",24,32,8,9,26,"10.2"
"49.584","Pat Connaughton",23,25,2,1,25,"5.4"
"49.587","Jimmy Conner",22,22,0,1,22,"4.4"
"49.590","Lester Conner",23,35,12,9,24,"Did Not Play (holdout)"
"49.593","Chuck Connors",25,26,1,1,25,"4.6"
"49.596","Will Conroy",24,30,6,9,27,"Did Not Play (other pro league—Turkey)"
"49.599","Anthony Cook",23,28,5,7,23,"Did Not Play (other pro league—France)"
"49.602","Bert Cook",25,25,0,1,25,"3.2"
"49.605","Bobby Cook",26,26,0,1,26,"11.5"
"49.608","Brian Cook",23,31,8,6,25,"7.9"
"49.611","Daequan Cook",20,25,5,5,21,"9.1"
"49.614","Darwin Cook",22,30,8,6,24,"Did Not Play (other pro league—CBA, Italy)"
"49.617","Jeff Cook",23,31,8,6,24,"Did Not Play (other pro league—Italy)"
"49.620","Norm Cook",21,22,1,2,21,"2.5"
"49.623","Omar Cook",22,23,1,2,23,"4.6"
"49.626","Quinn Cook",23,24,1,4,24,"9.5"
"49.629","Charles Cooke",23,23,0,1,23,"0.5"
"49.632","David Cooke",22,22,0,1,22,"1.5"
"49.635","Joe Cooke",22,22,0,1,22,"4.3"
"49.638","Jack Cooley",23,26,3,3,26,"Did Not Play"
"49.641","Chuck Cooper",24,29,5,5,24,"9.3"
"49.644","Duane Cooper",23,24,1,2,23,"2.4"
"49.647","Joe Cooper",24,27,3,7,27,"Did Not Play (other pro league—CBA)"
"49.652","Michael Cooper",22,33,11,1,25,"11.9"
"49.655","Wayne Cooper",22,35,13,5,29,"13.1"
"49.658","Tom Copa",27,27,0,1,27,"1.5"
"49.661","Chris Copeland",28,31,3,3,28,"8.7"
"49.664","Hollis Copeland",24,26,2,2,24,"Did Not Play (other pro league—Spain)"
"49.667","Lanard Copeland",24,26,2,3,24,"Did Not Play (other pro league—CBA)"
"49.670","Tyrone Corbin",23,38,15,10,28,"18"
"49.673","Chris Corchiani",23,25,2,4,23,"5"
"49.676","Ken Corley",NA,NA,NA,1,NA,"0"
"49.678","Ray Corley",22,25,3,6,22,"Did Not Play (other pro league—ABL)"
"49.681","Dave Corzine",22,34,12,5,26,"14"
"49.684","Larry Costello",23,36,13,5,27,"Did Not Play (other pro league—EBL)"
"49.687","Matt Costello",24,24,0,1,24,"1"
"49.690","Bryce Cotton",22,23,1,4,22,"5.3"
"49.693","Jack Cotton",25,25,0,1,25,"5.1"
"49.696","James Cotton",22,23,1,1,22,"2.7"
"49.699","John Coughran",28,28,0,1,28,"2.8"
"49.702","Mel Counts",23,34,11,7,28,"12.6"
"49.705","Steve Courtin",22,22,0,1,22,"4.2"
"49.708","Joe Courtney",23,27,4,9,24,"Did Not Play (other pro league—CBA)"
"49.712","Marcus Cousin",24,24,0,1,24,"1"
"49.716","DeMarcus Cousins",20,27,7,3,26,"27.8"
"49.719","Bob Cousy",22,41,19,3,23,"Did Not Play (retired)"
"49.722","Robert Covington",23,27,4,2,24,"13.5"
"49.725","Dave Cowens",22,34,12,3,24,"Did Not Play (retired)"
"49.728","Chubby Cox",27,27,0,1,27,"4.1"
"49.732","Johnny Cox",26,26,0,1,26,"7.8"
"49.735","Wesley Cox",23,24,1,1,24,"4.7"
"49.738","Allen Crabbe",21,25,4,2,25,"13.2"
"49.741","Torrey Craig",27,27,0,1,27,"4.2"
"49.744","Chris Crawford",22,28,6,1,28,"10.2"
"49.747","Freddie Crawford",25,29,4,6,26,"10.3"
"49.750","Jamal Crawford",20,37,17,8,27,"20.6"
"49.753","Joe Crawford",22,22,0,1,22,"4.5"
"49.756","Jordan Crawford",22,29,7,7,22,"Did Not Play"
"49.760","Jim Creighton",25,25,0,1,25,"1"
"49.763","Ron Crevier",27,27,0,3,27,"0"
"49.766","Hal Crisler",23,23,0,1,23,"1.5"
"49.769","Joe Crispin",22,22,0,3,22,"4.6"
"49.772","Charlie Criss",29,36,7,4,33,"12.9"
"49.775","Russell Critchfield",22,22,0,1,22,"3.4"
"49.778","Winston Crite",22,23,1,1,22,"3"
"49.781","Javaris Crittenton",20,21,1,4,20,"7.4"
"49.784","Dillard Crocker",24,28,4,6,25,"Did Not Play (other pro league—NPBL)"
"49.787","Bobby Croft",24,24,0,3,24,"7.9"
"49.790","Geoff Crompton",23,28,5,6,27,"Did Not Play (other pro league—Netherlands)"
"49.793","Terry Crosby",23,23,0,1,23,"1.5"
"49.796","Austin Croshere",22,33,11,6,24,"10.3"
"49.799","Jeff Cross",24,24,0,1,24,"1.2"
"49.802","Pete Cross",22,24,2,3,22,"8"
"49.805","Russell Cross",22,22,0,1,22,"3.7"
"49.808","Chink Crossin",24,26,2,1,26,"7"
"49.811","John Crotty",23,33,10,8,32,"6.9"
"49.814","Bill Crow",27,27,0,1,27,"3"
"49.817","Mark Crow",23,23,0,1,23,"5.6"
"49.820","Corey Crowder",22,25,3,4,22,"Did Not Play (other pro league—Spain)"
"49.823","Jae Crowder",22,27,5,5,25,"14.2"
"49.826","Al Cueto",23,24,1,2,23,"6"
"49.829","Pat Cummings",23,34,11,5,28,"15.8"
"49.832","Terry Cummings",21,38,17,8,21,"23.7"
"49.835","Vonteego Cummings",23,25,2,2,23,"9.4"
"49.838","Billy Cunningham",22,32,10,2,26,"26.1"
"49.841","Dante Cunningham",22,30,8,7,23,"9"
"49.844","Dick Cunningham",22,28,6,2,22,"4.6"
"49.847","Jared Cunningham",21,24,3,7,24,"4"
"49.850","William Cunningham",23,24,1,5,23,"1.3"
"49.853","Radisav Curcic",27,27,0,1,27,"2.9"
"49.855","Armand Cure",27,27,0,1,27,"0.8"
"49.858","Earl Cureton",23,39,16,11,28,"Did Not Play (other pro league—Italy)"
"49.862","Bill Curley",22,28,6,8,28,"Did Not Play (injury—knee)"
"49.865","Fran Curran",26,27,1,1,27,"6"
"49.868","Dell Curry",22,37,15,5,29,"16.3"
"49.871","Eddy Curry",19,30,11,5,24,"Did Not Play"
"49.873","JamesOn Curry",24,24,0,1,24,"0"
"49.876","Michael Curry",25,36,11,8,29,"Did Not Play (other pro league—Spain)"
"49.879","Seth Curry",23,26,3,6,26,"12.8"
"49.883","Stephen Curry",21,29,8,1,27,"30.1"
"49.886","Rastko Cvetkovic",25,25,0,1,25,"0.7"
"56.36","Mike D'Antoni",22,25,3,5,22,"4.8"
"56.39","Mike Dabich",25,25,0,3,25,"3.3"
"56.42","Ed Dahler",26,26,0,1,26,"2.5"
"56.45","Quintin Dailey",22,31,9,3,23,"18.2"
"56.48","Samuel Dalembert",20,33,13,7,25,"Did Not Play (injury—knee)"
"56.51","Howie Dallmar",24,26,2,1,25,"12.2"
"56.54","Erick Dampier",21,36,15,5,28,"12.3"
"56.57","Louie Dampier",23,34,11,2,25,"26"
"56.60","Bob Dandridge",22,34,12,2,28,"21.5"
"56.63","Antonio Daniels",22,35,13,9,29,"Did Not Play (contract bought out)"
"56.66","Erik Daniels",22,22,0,1,22,"0.6"
"56.69","Lloyd Daniels",25,30,5,8,25,"Did Not Play (other pro league—Italy)"
"56.72","Marquis Daniels",23,32,9,4,28,"13.6"
"56.75","Mel Daniels",23,32,9,5,24,"Did Not Play (other pro league—Italy)"
"56.78","Troy Daniels",22,26,4,6,26,"8.9"
"56.81","Sasha Danilovic",25,26,1,3,26,"16.6"
"56.83","Adrian Dantley",20,34,14,8,24,"30.7"
"56.86","Pete Darcey",22,22,0,1,22,"0.9"
"56.89","Jimmy Darden",27,27,0,1,27,"8.1"
"56.92","Ollie Darden",23,25,2,4,23,"12"
"56.95","Yinka Dare",22,25,3,1,23,"2.8"
"56.98","Jesse Dark",23,23,0,1,23,"3.6"
"56.101","Rick Darnell",23,23,0,1,23,"2.4"
"56.104","Jimmy Darrow",24,24,0,1,24,"2.4"
"56.107","Luigi Datome",26,27,1,3,27,"5.2"
"56.109","Brad Daugherty",21,28,7,1,25,"21.6"
"56.112","Mack Daughtry",NA,NA,NA,1,NA,"3.3"
"56.114","Kornel David",27,29,2,5,28,"6.5"
"56.116","Jermareo Davidson",23,24,1,2,23,"3.2"
"56.119","Bob Davies",29,35,6,1,32,"16.2"
"56.122","Brandon Davies",22,23,1,3,23,"6.3"
"56.125","Anthony Davis",19,24,5,2,24,"28.1"
"56.128","Antonio Davis",25,37,12,5,33,"14.5"
"56.131","Aubrey Davis",25,25,0,1,25,"4.9"
"56.134","Baron Davis",20,32,12,7,24,"22.9"
"56.137","Ben Davis",24,27,3,2,26,"2.1"
"56.141","Bill Davis",26,26,0,1,26,"1.8"
"56.144","Bob Davis",22,22,0,1,22,"1.8"
"56.147","Brad Davis",22,36,14,5,26,"12.1"
"56.150","Brian Davis",23,23,0,1,23,"1.9"
"56.153","Charles Davis",23,31,8,6,27,"Did Not Play (other pro league—Italy)"
"56.156","Charlie Davis",22,24,2,3,22,"9.8"
"56.159","Dale Davis",22,37,15,5,24,"11.7"
"56.162","Deyonta Davis",20,21,1,1,21,"5.8"
"56.165","Dwight Davis",23,27,4,2,24,"12.5"
"56.168","Ed Davis",21,28,7,5,23,"9.7"
"56.171","Emanual Davis",28,34,6,4,33,"Did Not Play (other pro league—France)"
"56.174","Glen Davis",22,29,7,4,27,"15.1"
"56.177","Harry Davis",23,24,1,2,23,"4.1"
"56.180","Hubert Davis",22,33,11,7,27,"11.1"
"56.183","Jim Davis",26,33,7,5,28,"13.6"
"56.186","Johnny Davis",21,30,9,5,23,"18.3"
"56.189","Josh Davis",23,31,8,12,25,"Did Not Play (other pro league—Ukraine)"
"56.192","Lee Davis",23,30,7,5,27,"13.3"
"56.195","Mark Davis",25,25,0,3,25,"4"
"56.198","Mark Davis",22,26,4,4,23,"8.5"
"56.202","Mel Davis",23,26,3,3,26,"8.7"
"56.205","Mickey Davis",21,26,5,2,23,"5.9"
"56.208","Mike Davis",23,26,3,4,23,"11.9"
"56.211","Mike Davis",26,26,0,1,26,"1.8"
"56.214","Monti Davis",22,22,0,3,22,"2"
"56.217","Paul Davis",22,25,3,2,24,"4"
"56.220","Ralph Davis",22,23,1,2,23,"10.4"
"56.223","Red Davis",23,23,0,1,23,"0.7"
"56.226","Ricky Davis",19,30,11,7,23,"20.6"
"56.229","Ron Davis",22,27,5,3,26,"Did Not Play (other pro league—CBA)"
"56.232","Terry Davis",22,33,11,5,25,"Did Not Play"
"56.235","Walt Davis",23,27,4,3,26,"6.6"
"56.238","Walter Davis",23,37,14,4,23,"24.2"
"56.241","Warren Davis",24,29,5,8,24,"17"
"56.244","Willie Davis",25,25,0,1,25,"2.3"
"56.247","Andre Dawkins",23,23,0,1,23,"0.8"
"56.250","Darryl Dawkins",19,32,13,5,27,"16.8"
"56.252","Johnny Dawkins",23,31,8,3,24,"15.8"
"56.255","Paul Dawkins",22,22,0,1,22,"5.5"
"56.258","Branden Dawson",22,22,0,1,22,"0.8"
"56.261","Eric Dawson",27,27,0,1,27,"3.8"
"56.264","Jimmy Dawson",22,22,0,1,22,"5.6"
"56.267","Tony Dawson",23,27,4,5,27,"Did Not Play (other pro league—Spain)"
"56.270","Todd Day",23,31,8,7,25,"Did Not Play (other pro league—CBA)"
"56.273","Austin Daye",21,26,5,6,22,"7.5"
"56.276","Darren Daye",23,27,4,4,24,"8.7"
"56.279","Nando De Colo",25,26,1,3,26,"4.3"
"56.281","Greg Deane",22,22,0,1,22,"1.4"
"56.284","Billy DeAngelis",24,24,0,1,24,"1.3"
"56.287","Dave DeBusschere",22,33,11,3,26,"18.2"
"56.290","Andrew DeClercq",22,31,9,5,25,"9"
"56.293","Dewayne Dedmon",24,28,4,6,28,"10"
"56.296","Don Dee",25,25,0,1,25,"5.7"
"56.299","Archie Dees",22,25,3,5,23,NA
"56.302","Terry Dehere",22,27,5,4,24,"12.4"
"56.305","Red Dehnert",23,23,0,1,23,"1.4"
"56.308","Bryce Dejean-Jones",23,23,0,1,23,"5.6"
"56.313","Sam Dekker",21,23,2,2,22,"6.5"
"56.316","Vinny Del Negro",22,35,13,7,29,"Did Not Play (other pro league—Italy)"
"56.319","Malcolm Delaney",27,28,1,1,28,"6.3"
"56.322","Bison Dele",22,29,7,5,28,"16.2"
"56.326","Carlos Delfino",22,30,8,5,28,"Did Not Play (other pro league—Russia)"
"56.328","Tony Delk",23,32,9,9,27,"12.3"
"56.331","Matthew Dellavedova",23,27,4,2,26,"7.6"
"56.334","Nate DeLong",26,26,0,1,26,"3.8"
"56.337","Fennis Dembo",23,23,0,1,23,"1.2"
"56.340","Larry Demic",22,24,2,1,22,"7"
"56.343","Dell Demps",23,26,3,4,25,"Did Not Play (other pro league—CBA)"
"56.346","George Dempsey",25,29,4,3,25,"7.3"
"56.349","Luol Deng",19,32,13,5,28,"19"
"56.352","Kenny Dennard",23,25,2,2,23,"5"
"56.355","Blaine Denning",22,22,0,1,22,"5"
"56.358","Justin Dentmon",26,27,1,4,26,"5.5"
"56.361","Randy Denton",22,27,5,7,26,"17.3"
"56.364","Joe DePre",23,25,2,1,23,"8.8"
"56.367","Rod Derline",22,23,1,1,22,"5.6"
"56.370","DeMar DeRozan",20,28,8,1,27,"27.3"
"56.373","Dave Deutsch",21,21,0,1,21,"1.1"
"56.376","Corky Devlin",24,26,2,2,24,"7.9"
"56.379","Hank DeZonie",28,28,0,1,28,"3.4"
"56.382","Derrick Dial",24,28,4,6,24,"Did Not Play (other pro league—Italy)"
"56.385","Cheick Diallo",20,21,1,1,20,"5.1"
"56.388","Boris Diaw",21,34,13,6,26,"15.1"
"56.390","Yakhouba Diawara",24,27,3,2,24,"4.4"
"56.393","Guillermo Diaz",22,22,0,1,22,"0.8"
"56.396","Dan Dickau",24,29,5,7,26,"13.2"
"56.400","Kaniel Dickens",25,29,4,5,25,"Did Not Play (other pro league—Ukraine)"
"56.404","Henry Dickerson",24,25,1,2,25,"2.8"
"56.407","Michael Dickerson",23,27,4,3,24,"18.2"
"56.410","Clyde Dickey",23,23,0,1,23,"2.8"
"56.413","Derrek Dickey",22,26,4,3,23,"7.7"
"56.416","Dick Dickey",25,25,0,1,25,"2.8"
"56.419","John Dickson",22,22,0,1,22,"1.7"
"56.422","Travis Diener",23,27,4,4,25,"6.9"
"56.425","Gorgui Dieng",24,28,4,1,26,"10.1"
"56.428","Connie Dierking",22,34,12,7,33,"Did Not Play (other pro league—ABL)"
"56.431","Coby Dietrick",22,34,12,5,28,"8.4"
"56.434","Ernie DiGregorio",23,27,4,4,23,"15.2"
"56.437","Craig Dill",23,23,0,1,23,"6.8"
"56.440","Dwaine Dillard",26,26,0,1,26,"1.3"
"56.443","Mickey Dillard",23,23,0,1,23,"2.2"
"56.446","Bob Dille",29,29,0,1,29,"5.2"
"56.449","Hook Dillon",26,26,0,1,26,"1.6"
"56.452","Byron Dinkins",22,23,1,4,22,"3.5"
"56.455","Jackie Dinkins",22,22,0,1,22,"2.5"
"56.458","Harry Dinnel",27,27,0,1,27,"1.7"
"56.461","Bill Dinwiddie",24,28,4,4,24,"Did Not Play (injury—knee)"
"56.464","Spencer Dinwiddie",21,24,3,2,24,"12.6"
"56.467","Ike Diogu",22,28,6,8,25,"Did Not Play"
"56.470","DeSagana Diop",20,31,11,5,26,"3"
"56.472","Terry Dischinger",22,32,10,5,22,"Did Not Play (military service)"
"56.475","Fred Diute",26,26,0,1,26,"1.6"
"56.478","Vlade Divac",21,36,15,3,26,"16"
"56.480","Juan Dixon",24,30,6,5,27,"12.3"
"56.483","Aleksandar Djordjevic",29,29,0,1,29,"3.1"
"56.485","Earl Dodd",25,25,0,1,25,"1.7"
"56.488","Michael Doleac",21,30,9,7,22,"7"
"56.491","Joe Dolhon",22,23,1,1,22,"6.9"
"56.494","Bob Doll",27,30,3,2,28,"10.6"
"56.497","James Donaldson",23,37,14,8,26,"Did Not Play (other pro league—Greece)"
"56.500","Bob Donham",24,27,3,1,25,"8.3"
"56.503","Billy Donovan",22,22,0,1,22,"2.4"
"56.506","Harry Donovan",23,23,0,1,23,"5.6"
"56.509","Keyon Dooling",20,32,12,7,28,"9.7"
"56.512","Jacky Dorsey",23,26,3,6,23,"Did Not Play"
"56.515","Joey Dorsey",25,31,6,5,27,"Did Not Play"
"56.518","Ron Dorsey",23,23,0,1,23,"4"
"56.521","Tyler Dorsey",21,21,0,1,21,"7.2"
"56.524","Damyean Dotson",23,23,0,1,23,"4.1"
"56.528","Quincy Douby",22,24,2,3,23,"4.8"
"56.531","Bruce Douglas",22,22,0,1,22,"1.8"
"56.534","John Douglas",25,26,1,1,25,"7"
"56.537","Leon Douglas",22,28,6,2,24,"11.4"
"56.540","Sherman Douglas",23,34,11,6,24,"18.5"
"56.543","Toney Douglas",23,30,7,8,24,"10.6"
"56.547","Chris Douglas-Roberts",22,28,6,6,23,"Did Not Play"
"56.550","Sonny Dove",22,26,4,2,24,"14.4"
"56.553","Jerry Dover",22,22,0,1,22,"2"
"56.556","Zabian Dowdell",26,26,0,1,26,"5"
"56.559","Bill Downey",24,24,0,1,24,"0"
"56.562","Steve Downing",23,24,1,1,23,"2.7"
"56.565","Danny Doyle",22,22,0,1,22,"4"
"56.568","Milton Doyle",24,24,0,1,24,"3.4"
"56.571","PJ Dozier",21,21,0,1,21,"1"
"56.574","Terry Dozier",23,23,0,1,23,"2.4"
"56.577","Goran Dragic",22,31,9,4,27,"20.3"
"56.579","Zoran Dragic",25,25,0,3,25,"2.2"
"56.581","Greg Dreiling",24,34,10,4,28,"Did Not Play (other pro league—CBA)"
"56.585","Bryce Drew",24,29,5,4,26,"6.3"
"56.588","John Drew",20,30,10,2,22,"24.2"
"56.591","Larry Drew",22,32,10,6,24,"Did Not Play (other pro league—Italy)"
"56.594","Larry Drew",24,27,3,4,24,"Did Not Play"
"56.598","Clyde Drexler",21,35,14,3,26,"27.2"
"56.601","Nate Driggers",23,23,0,1,23,"2.4"
"56.604","Terry Driscoll",23,27,4,5,25,"5.5"
"56.607","Predrag Drobnjak",26,29,3,3,27,"9.4"
"56.609","Ralph Drollinger",26,26,0,1,26,"2.5"
"56.612","Andre Drummond",19,24,5,1,22,"16.2"
"56.615","Dick Duckett",24,24,0,1,24,"3.9"
"56.618","Kevin Duckworth",22,32,10,6,24,"18.1"
"56.621","Charles Dudley",22,28,6,4,26,"Did Not Play"
"56.624","Chris Dudley",22,37,15,6,25,"7.1"
"56.627","Jared Dudley",22,32,10,6,26,"12.7"
"56.630","Terry Duerod",23,26,3,5,23,"9.3"
"56.633","Bob Duffy",24,24,0,3,24,"1.3"
"56.636","Bob Duffy",22,24,2,4,23,"5.1"
"56.639","Chris Duhon",22,30,8,4,26,"11.1"
"56.642","Duje Dukan",24,24,0,1,24,"6"
"56.645","Walter Dukes",25,32,7,3,29,"15.2"
"56.648","Joe Dumars",22,35,13,1,29,"23.5"
"56.651","Rich Dumas",NA,NA,NA,1,NA,"2"
"56.653","Richard Dumas",23,26,3,3,23,"Did Not Play (suspended—substance abuse)"
"56.656","Tony Dumas",22,25,3,4,23,"11.6"
"56.659","Andy Duncan",26,28,2,2,26,"7.4"
"56.662","Tim Duncan",21,39,18,1,25,"25.5"
"56.665","Mike Dunleavy",22,35,13,6,29,"Did Not Play (retired)"
"56.668","Mike Dunleavy",22,36,14,7,27,"19.1"
"56.671","Kris Dunn",22,23,1,2,23,"13.4"
"56.674","Pat Dunn",26,26,0,1,26,"2.5"
"56.677","T.R. Dunn",22,35,13,3,26,"8.2"
"56.680","Ronald Dupree",23,30,7,8,23,"Did Not Play (other pro league—Germany)"
"56.683","Kevin Durant",19,29,10,3,25,"32"
"56.686","John Duren",22,24,2,2,24,"4.5"
"56.689","Jarrett Durham",22,22,0,1,22,"0"
"56.692","Pat Durham",25,27,2,3,27,"Did Not Play (other pro league—France)"
"56.695","Devin Durrant",24,25,1,2,24,"5.1"
"56.698","Ken Durrett",23,26,3,4,25,"4.8"
"56.701","Dennis DuVal",22,23,1,2,23,"2.8"
"56.704","Jack Dwan",27,27,0,1,27,"4.6"
"56.707","Craig Dykema",22,22,0,1,22,"1.3"
"56.710","Gene Dyker",23,23,0,1,23,"1.5"
"56.713","Jerome Dyson",24,24,0,1,24,"7.4"
"63.36","Ledell Eackles",22,31,9,6,23,"Did Not Play (other pro league—Israel)"
"63.39","Jim Eakins",22,31,9,9,26,"15"
"63.42","Acie Earl",23,26,3,4,25,"7.5"
"63.45","Ed Earle",26,26,0,1,26,"2"
"63.48","Cleanthony Early",23,24,1,1,23,"5.4"
"63.51","Penny Early",25,25,0,1,25,"0"
"63.53","Mark Eaton",26,36,10,1,28,"9.7"
"63.56","Jerry Eaves",23,27,4,4,23,"Did Not Play"
"63.59","Devin Ebanks",21,23,2,1,22,"4"
"63.62","Bill Ebben",22,22,0,1,22,"1.9"
"63.65","Al Eberhard",22,25,3,1,23,"9.3"
"63.68","Ndudi Ebi",19,20,1,1,20,"13.5"
"63.70","Roy Ebron",22,22,0,1,22,"6.2"
"63.73","Jarell Eddie",24,26,2,5,25,"4.8"
"63.76","Patrick Eddie",24,24,0,1,24,"1"
"63.80","Dike Eddleman",27,30,3,4,28,"15.3"
"63.83","Kenton Edelin",22,22,0,1,22,"1.1"
"63.86","Charles Edge",23,24,1,2,23,"9.6"
"63.89","Bobby Edmonds",26,28,2,2,26,"Did Not Play"
"63.92","Keith Edmonson",22,23,1,4,23,"8.7"
"63.95","Tyus Edney",22,27,5,5,22,"Did Not Play (other pro league—Lithuania)"
"63.98","Bill Edwards",22,22,0,1,22,"2"
"63.101","Blue Edwards",24,33,9,6,27,"16.9"
"63.104","Corsley Edwards",25,25,0,1,25,"2.7"
"63.107","Doug Edwards",23,25,2,2,25,"3"
"63.110","Franklin Edwards",22,28,6,3,26,"9"
"63.113","James Edwards",22,40,18,9,23,"16.7"
"63.116","Jay Edwards",21,21,0,1,21,"1.8"
"63.119","John Edwards",23,24,1,2,24,"1.8"
"63.122","Kevin Edwards",23,35,12,6,28,"Did Not Play"
"63.125","Shane Edwards",26,26,0,1,26,"1"
"63.128","Johnny Egan",23,33,10,8,25,"14.1"
"63.131","Lonnie Eggleston",30,30,0,1,30,"2"
"63.134","Bulbs Ehlers",24,25,1,1,25,"8.7"
"63.137","Craig Ehlo",22,35,13,4,28,"13.6"
"63.140","Rich Eichhorst",28,28,0,1,28,"2"
"63.143","Howard Eisley",22,33,11,9,30,"9.1"
"63.146","Obinna Ekezie",24,29,5,8,29,"Did Not Play (other pro league—Serbia)"
"63.149","Khalid El-Amin",21,21,0,1,21,"6.3"
"63.152","Don Eliason",28,28,0,1,28,"0"
"63.155","Mario Elie",27,37,10,7,33,"11.7"
"63.158","Ray Ellefson",26,28,2,3,28,"Did Not Play (other pro team—New York Celtics)"
"63.161","Henry Ellenson",20,21,1,1,21,"4"
"63.164","Wayne Ellington",22,30,8,8,30,"11.2"
"63.167","Bob Elliott",23,25,2,1,23,"8.8"
"63.170","Sean Elliott",21,32,11,2,27,"20"
"63.173","Bo Ellis",23,25,2,1,23,"4.3"
"63.176","Boo Ellis",22,23,1,1,22,"5.9"
"63.179","Dale Ellis",23,39,16,7,28,"27.5"
"63.182","Harold Ellis",23,27,4,3,23,"Did Not Play (other pro league—Greece)"
"63.185","Joe Ellis",22,29,7,2,25,"15.8"
"63.188","LaPhonso Ellis",22,32,10,4,26,"21.9"
"63.191","LeRon Ellis",22,26,4,5,24,"Did Not Play (other pro league—Spain)"
"63.195","Leroy Ellis",22,35,13,5,30,"15.9"
"63.198","Monta Ellis",20,31,11,5,24,"25.5"
"63.200","Pervis Ellison",22,33,11,5,24,"Did Not Play (injury)"
"63.203","Len Elmore",22,31,9,6,23,"14.6"
"63.206","Francisco Elson",27,35,8,7,30,"5"
"63.209","Darrell Elston",22,24,2,3,22,"Did Not Play"
"63.212","Melvin Ely",24,35,11,8,27,"Did Not Play"
"63.215","Joel Embiid",22,23,1,1,23,"22.9"
"63.218","Wayne Embry",21,31,10,3,24,"19.8"
"63.221","Andre Emmett",22,29,7,8,29,"Did Not Play (other pro league—Lithuania, D-League)"
"63.224","Ned Endress",28,28,0,1,28,"0.9"
"63.227","Chris Engler",23,28,5,7,25,"Did Not Play (other pro league—Italy)"
"63.231","Wayne Englestad",22,22,0,1,22,"2.5"
"63.234","A.J. English",23,24,1,1,24,"10.9"
"63.237","Alex English",23,37,14,5,32,"29.8"
"63.240","Claude English",24,24,0,1,24,"1.5"
"63.243","Jo Jo English",22,24,2,1,24,"5.4"
"63.246","Kim English",24,24,0,1,24,"2.9"
"63.249","Scott English",22,24,2,3,24,"6.9"
"63.252","Gene Englund",32,32,0,3,32,"8.2"
"63.255","James Ennis",24,27,3,5,25,"15.9"
"63.258","Tyler Ennis",20,23,3,5,22,"7.7"
"63.261","Ray Epps",22,22,0,1,22,"2"
"63.264","Semih Erden",24,25,1,3,24,"4.1"
"63.266","Bo Erias",25,25,0,1,25,"8.2"
"63.269","Keith Erickson",21,32,11,4,29,"14.6"
"63.272","Julius Erving",21,36,15,3,22,"31.9"
"63.275","Evan Eschmeyer",24,27,3,2,25,"3.4"
"63.278","Jack Eskridge",25,25,0,3,25,"3.2"
"63.281","Vincenzo Esposito",27,27,0,1,27,"3.9"
"63.283","Billy Evans",22,22,0,1,22,"1.9"
"63.286","Bob Evans",24,24,0,1,24,"3"
"63.289","Brian Evans",23,25,2,4,24,"4.7"
"63.292","Earl Evans",24,24,0,1,24,"4.4"
"63.296","Jawun Evans",21,21,0,1,21,"4.8"
"63.299","Jeremy Evans",23,30,7,4,26,"Did Not Play"
"63.302","Maurice Evans",23,33,10,10,32,"Did Not Play (other pro league—Italy)"
"63.306","Mike Evans",24,32,8,5,29,"10.1"
"63.309","Reggie Evans",22,34,12,8,25,"5.9"
"63.312","Tyreke Evans",20,28,8,4,20,"20.1"
"63.315","Daniel Ewing",22,23,1,1,22,"3.8"
"63.318","Patrick Ewing",23,39,16,3,27,"28.6"
"63.321","Patrick Ewing",26,26,0,1,26,"0.4"
"63.325","Dante Exum",19,22,3,2,22,"Did Not Play"
"63.327","Christian Eyenga",21,22,1,3,22,"8"
"63.329","Festus Ezeli",23,26,3,2,26,"Did Not Play"
"63.332","Johnny Ezersky",25,27,2,4,26,"10.3"
"70.36","Joe Fabel",33,33,0,1,33,"2.1"
"70.39","John Fairchild",22,26,4,7,24,"Did Not Play"
"70.42","Phil Farbman",24,24,0,3,24,"3.4"
"70.45","Kenneth Faried",22,28,6,1,24,"13.7"
"70.48","Dick Farley",22,26,4,3,26,"Did Not Play (military service—U.S. Air Force)"
"70.51","Jordan Farmar",20,30,10,6,25,"Did Not Play"
"70.54","Desmon Farmer",25,27,2,3,27,"Did Not Play"
"70.57","Jim Farmer",23,29,6,8,26,"Did Not Play (other pro league—CBA)"
"70.60","Mike Farmer",22,29,7,5,24,"Did Not Play (other pro league—ABL)"
"70.63","Tony Farmer",28,30,2,3,30,"Did Not Play (other pro league—Belgium)"
"70.67","Bob Faught",25,25,0,1,25,"6.7"
"70.70","Vitor Faverani",25,25,0,1,25,"4.4"
"70.72","Derrick Favors",19,26,7,3,24,"16.4"
"70.75","Nick Fazekas",22,22,0,3,22,"4.7"
"70.78","Dave Fedor",22,22,0,1,22,"0.9"
"70.81","Bob Feerick",27,30,3,1,27,"16.8"
"70.84","Butch Feher",22,22,0,1,22,"5.2"
"70.87","Jamie Feick",22,26,4,5,24,"6.8"
"70.90","Ron Feiereisel",24,24,0,1,24,"3"
"70.93","George Feigenbaum",20,23,3,3,23,"Did Not Play (other pro league—ABL)"
"70.96","Dave Feitl",24,29,5,5,25,"Did Not Play (other pro league—Italy)"
"70.99","Kay Felder",21,22,1,4,21,"4"
"70.102","Cristiano Felicio",23,25,2,1,25,"5.6"
"70.104","Carrick Felix",23,23,0,1,23,"2.7"
"70.107","Noel Felix",24,24,0,1,24,"1.5"
"70.110","Ray Felix",23,31,8,5,23,"17.6"
"70.113","Raymond Felton",21,33,12,8,26,"17.1"
"70.116","Jake Fendley",22,23,1,1,22,"3.2"
"70.119","Warren Fenley",24,24,0,1,24,"2.6"
"70.122","Desmond Ferguson",26,26,0,1,26,"1.9"
"70.126","Terrance Ferguson",19,19,0,1,19,"3.1"
"70.128","Rudy Fernandez",23,26,3,2,23,"10.4"
"70.130","Eric Fernsten",22,30,8,6,26,"Did Not Play (other pro league—Italy)"
"70.133","Al Ferrari",22,29,7,3,26,"Did Not Play (military service—U.S. Army)"
"70.136","Rolando Ferreira",24,24,0,1,24,"0.8"
"70.139","Duane Ferrell",23,33,10,3,26,"12.7"
"70.142","Yogi Ferrell",23,24,1,3,23,"11.3"
"70.145","Arnie Ferrin",23,25,2,1,23,"7.3"
"70.148","Bob Ferry",22,31,9,3,24,"13.9"
"70.151","Danny Ferry",24,36,12,2,29,"13.3"
"70.154","Kyrylo Fesenko",21,25,4,2,25,"2.7"
"70.156","Bobby Fields",22,22,0,1,22,"2.5"
"70.159","Kenny Fields",22,25,3,3,24,"8.7"
"70.162","Landry Fields",22,26,4,2,22,"9.7"
"70.165","Ron Filipek",23,23,0,1,23,"2.3"
"70.168","Greg Fillmore",23,24,1,1,23,"2.6"
"70.171","Larry Finch",22,23,1,2,23,"10.5"
"70.174","Hank Finkel",24,32,8,3,25,"11.6"
"70.177","Michael Finley",22,36,14,5,26,"22.6"
"70.180","Danny Finn",24,26,2,1,24,"11.9"
"70.183","Dorian Finney-Smith",23,24,1,1,24,"5.9"
"70.186","Matt Fish",25,27,2,6,26,"6"
"70.189","Derek Fisher",22,39,17,6,31,"13.3"
"70.192","Richard Fisher",23,23,0,3,23,"3.4"
"70.195","Gerald Fitch",23,23,0,1,23,"4.7"
"70.198","Bob Fitzgerald",23,25,2,5,23,"Did Not Play (other pro league—NBL)"
"70.201","Dick Fitzgerald",26,27,1,2,26,"4.6"
"70.204","Marcus Fizer",22,27,5,3,23,"12.3"
"70.207","Jerry Fleishman",24,30,6,2,30,"Did Not Play (other pro league—ABL)"
"70.210","Al Fleming",23,23,0,1,23,"2"
"70.213","Ed Fleming",22,26,4,2,22,"12.5"
"70.216","Vern Fleming",22,33,11,2,26,"14.3"
"70.219","Luis Flores",23,23,0,3,23,"3"
"70.223","Bruce Flowers",25,25,0,1,25,"4.9"
"70.226","Sleepy Floyd",22,34,12,5,27,"21.2"
"70.229","Jonny Flynn",20,22,2,4,20,"13.5"
"70.232","Mike Flynn",22,24,2,2,23,"8.2"
"70.235","Larry Fogle",22,22,0,1,22,"1"
"70.238","Jack Foley",23,23,0,3,23,"6.4"
"70.241","Isaac Fontaine",26,26,0,1,26,"1.8"
"70.244","Levi Fontaine",22,22,0,1,22,"3.8"
"70.247","Jeff Foote",24,24,0,1,24,"1"
"70.250","Bryn Forbes",23,24,1,1,24,"6.9"
"70.253","Gary Forbes",25,26,1,2,26,"6.6"
"70.257","Alphonso Ford",22,23,1,2,23,"3.8"
"70.260","Alton Ford",20,22,2,2,20,"3.1"
"70.263","Bob Ford",23,23,0,1,23,"1.6"
"70.266","Chris Ford",24,33,9,3,30,"15.6"
"70.269","Don Ford",23,29,6,3,23,"9.6"
"70.273","Jake Ford",24,25,1,1,24,"6.8"
"70.276","Phil Ford",22,28,6,5,24,"17.5"
"70.279","Sharrod Ford",24,24,0,1,24,"1.3"
"70.282","Sherell Ford",23,23,0,1,23,"3.2"
"70.285","T.J. Ford",20,28,8,5,25,"Did Not Play (injury—back)"
"70.288","Donnie Forman",23,23,0,1,23,"4.1"
"70.291","Bayard Forrest",23,24,1,1,23,"4.2"
"70.294","Joseph Forte",20,21,1,2,21,"1.4"
"70.297","Courtney Fortson",23,23,0,3,23,"4.3"
"70.300","Danny Fortson",21,30,9,5,24,"16.7"
"70.303","Fred Foster",22,30,8,7,23,"Did Not Play"
"70.306","Greg Foster",22,34,12,10,26,"6.1"
"70.310","Jeff Foster",23,35,12,1,28,"7"
"70.313","Jimmy Foster",23,24,1,2,23,"4.5"
"70.316","Rod Foster",23,25,2,1,24,"8.8"
"70.319","Antonis Fotsis",20,20,0,1,20,"3.9"
"70.321","Evan Fournier",20,25,5,2,25,"17.8"
"70.323","Larry Foust",22,33,11,4,26,NA
"70.326","Calvin Fowler",29,29,0,1,29,"4.4"
"70.329","Jerry Fowler",24,24,0,1,24,"1.5"
"70.332","Tremaine Fowlkes",25,28,3,3,26,"4.4"
"70.336","De'Aaron Fox",20,20,0,1,20,"11.6"
"70.339","Harold Fox",23,23,0,1,23,"3.1"
"70.342","Jim Fox",24,33,9,8,25,"13.8"
"70.345","Rick Fox",22,34,12,2,27,"15.4"
"70.348","Randy Foye",23,33,10,8,25,"16.3"
"70.351","Adonal Foyle",22,33,11,4,25,"5.9"
"70.354","Richie Frahm",26,30,4,7,28,"Did Not Play (other pro league—Italy)"
"70.357","Steve Francis",22,30,8,4,24,"21.6"
"70.360","Tellis Frank",22,28,6,4,24,"Did Not Play (other pro league—Italy)"
"70.363","Nat Frankel",33,33,0,1,33,"2.7"
"70.366","Jamaal Franklin",22,23,1,2,22,"1.9"
"70.369","William Franklin",23,26,3,3,23,"Did Not Play"
"70.372","Ronald Franz",22,27,5,6,23,"14.5"
"70.375","Tim Frazier",24,27,3,5,25,"13.1"
"70.378","Walt Frazier",22,34,12,2,26,"23.2"
"70.381","Will Frazier",23,26,3,4,25,"Did Not Play"
"70.384","Anthony Frederick",24,27,3,4,27,"Did Not Play (other pro league—Spain)"
"70.387","Jimmer Fredette",22,26,4,5,22,"7.6"
"70.390","World B. Free",22,34,12,6,26,"30.2"
"70.393","Joel Freeland",25,27,2,1,27,"3.5"
"70.395","Donnie Freeman",23,31,8,9,25,"27.4"
"70.398","Gary Freeman",22,22,0,3,22,"3.7"
"70.401","Rod Freeman",23,23,0,1,23,"3"
"70.404","Matt Freije",23,25,2,3,23,"Did Not Play (other pro league—CBA, Puerto Rico)"
"70.407","Frido Frey",25,25,0,1,25,"3.8"
"70.410","Larry Friend",22,22,0,1,22,"4"
"70.413","Pat Frink",23,23,0,1,23,"2.6"
"70.416","Jim Fritsche",22,23,1,4,22,"4.2"
"70.419","Channing Frye",22,34,12,8,27,"Did Not Play (medical condition—enlarged heart)"
"70.422","Bernie Fryer",24,25,1,4,25,"7.8"
"70.425","Frank Fucarino",26,26,0,1,26,"5"
"70.428","Herm Fuetsch",29,29,0,1,29,"2.6"
"70.430","Joe Fulks",25,32,7,1,27,"26"
"70.433","Carl Fuller",25,26,1,1,25,"5.9"
"70.436","Hiram Fuller",22,22,0,1,22,"2"
"70.439","Todd Fuller",22,26,4,4,22,"4.1"
"70.442","Tony Fuller",22,22,0,1,22,"4"
"70.445","Markelle Fultz",19,19,0,1,19,"7.1"
"70.448","Lawrence Funderburke",27,34,7,3,27,"Did Not Play (injury—achilles)"
"70.452","Terry Furlow",22,25,3,5,25,"16"
"77.36","Bill Gabor",27,32,5,1,28,"11.3"
"77.39","Dan Gadzuric",24,33,9,5,26,"7.3"
"77.42","Deng Gai",23,23,0,1,23,"0"
"77.45","Elmer Gainer",29,31,2,3,31,"Did Not Play (other pro league—NBL)"
"77.48","Bill Gaines",22,22,0,1,22,"2"
"77.51","Corey Gaines",23,29,6,5,25,"Did Not Play (other pro league—CBA)"
"77.55","David Gaines",25,25,0,1,25,"3.3"
"77.58","Reece Gaines",23,25,2,4,24,"2.6"
"77.61","Sundiata Gaines",23,25,2,5,24,"5.8"
"77.64","Mike Gale",21,31,10,7,26,"10.3"
"77.67","Chad Gallagher",24,24,0,1,24,"3"
"77.70","Harry Gallatin",21,30,9,2,29,"15"
"77.73","Danilo Gallinari",20,29,9,5,27,"Did Not Play (injury—ACL)"
"77.75","Langston Galloway",23,26,3,5,23,"11.8"
"77.78","Dave Gambee",21,32,11,9,24,NA
"77.81","Kevin Gamble",22,31,9,5,25,"15.6"
"77.84","Bob Gantt",24,24,0,1,24,"3.1"
"77.87","Jorge Garbajosa",29,30,1,1,29,"8.5"
"77.89","Ruben Garces",27,27,0,3,27,"1.6"
"77.92","Alex Garcia",23,24,1,2,24,"5.5"
"77.94","Francisco Garcia",24,33,9,3,27,"12.7"
"77.97","Chuck Gardner",23,23,0,1,23,"4.7"
"77.100","Earl Gardner",25,25,0,1,25,"1.8"
"77.103","Kenneth Gardner",26,26,0,1,26,"1.6"
"77.106","Thomas Gardner",22,23,1,2,22,"5.3"
"77.109","Vern Gardner",24,26,2,1,24,"13.5"
"77.112","Jack Garfinkel",28,30,2,1,29,"6.1"
"77.115","Patricio Garino",23,23,0,1,23,"0"
"77.118","Gary Garland",22,22,0,1,22,"4.3"
"77.121","Winston Garland",23,30,7,7,24,"Did Not Play (other pro league—Italy)"
"77.124","Dick Garmaker",23,28,5,3,24,"16.3"
"77.127","Bill Garner",27,27,0,1,27,"1.5"
"77.130","Chris Garner",22,25,3,4,25,"Did Not Play (other pro league—CBA)"
"77.133","Bill Garnett",22,25,3,2,24,"6.4"
"77.136","Kevin Garnett",19,39,20,4,27,"24.2"
"77.138","Marlon Garnett",23,23,0,1,23,"2.1"
"77.141","Calvin Garrett",24,27,3,2,24,"6.1"
"77.145","Dean Garrett",30,35,5,4,30,"8"
"77.148","Diante Garrett",24,25,1,2,25,"3.5"
"77.151","Dick Garrett",23,27,4,5,24,"12.9"
"77.154","Rowland Garrett",22,26,4,4,25,"10.9"
"77.157","Tom Garrick",22,25,3,5,23,"7"
"77.160","John Garris",24,24,0,1,24,"4"
"77.164","Kiwane Garris",23,25,2,3,23,"Did Not Play (other pro league—Germany)"
"77.167","Pat Garrity",22,31,9,2,25,"11.1"
"77.170","Jim Garvin",23,23,0,1,23,"0.3"
"77.173","Marc Gasol",24,33,9,1,32,"19.5"
"77.175","Pau Gasol",21,37,16,5,26,"20.8"
"77.177","Frank Gates",29,29,0,1,29,"4.5"
"77.180","Chris Gatling",24,34,10,9,29,"19.1"
"77.183","Kenny Gattison",22,31,9,4,27,"Did Not Play (injury)"
"77.186","Rudy Gay",20,31,11,5,28,"21.1"
"77.189","Ed Gayda",23,23,0,1,23,"3.7"
"77.192","Andrew Gaze",28,33,5,3,28,"Did Not Play (other pro league—Australia)"
"77.195","Michael Gbinije",24,24,0,1,24,"0.4"
"77.199","Reggie Geary",23,24,1,2,24,"2.5"
"77.202","Alonzo Gee",22,29,7,7,24,"10.6"
"77.205","Matt Geiger",23,32,9,3,29,"13.5"
"77.209","Mickael Gelabale",23,29,6,5,29,"Did Not Play (other pro league—France)"
"77.211","Devean George",22,32,10,3,26,"7.4"
"77.214","Jack George",25,32,7,3,27,"13.9"
"77.217","Paul George",20,27,7,2,26,"23.7"
"77.220","Tate George",22,26,4,3,23,"Did Not Play (other pro league—CBA)"
"77.223","Marcus Georges-Hunt",22,23,1,2,22,"2.8"
"77.226","Gus Gerard",21,27,6,8,21,"15.7"
"77.229","Derrick Gervin",26,27,1,1,26,"12"
"77.232","George Gervin",20,33,13,5,27,"33.1"
"77.235","Gorham Getchell",26,26,0,1,26,"0.3"
"77.238","John Gianelli",22,29,7,5,26,"10.9"
"77.241","Dick Gibbs",23,27,4,6,25,"10.8"
"77.244","Daniel Gibson",20,26,6,1,24,"11.6"
"77.247","Dee Gibson",26,26,0,1,26,"6.4"
"77.250","Hoot Gibson",28,28,0,3,28,"5.6"
"77.253","Jonathan Gibson",29,30,1,2,30,"8.5"
"77.256","Mel Gibson",23,23,0,1,23,"1.4"
"77.259","Mike Gibson",23,25,2,3,23,"Did Not Play (other pro league—Italy)"
"77.262","Taj Gibson",24,32,8,4,28,"13"
"77.265","J.R. Giddens",23,24,1,3,24,"4.1"
"77.269","Trey Gilder",25,25,0,1,25,"1"
"77.273","Eddie Gill",22,30,8,9,23,"Did Not Play (other pro league—Russia)"
"77.276","Kendall Gill",22,36,14,8,28,"21.8"
"77.279","Ben Gillery",23,23,0,1,23,"1"
"77.282","Jack Gillespie",22,22,0,1,22,"1"
"77.285","Gene Gillette",NA,NA,NA,1,NA,"0.6"
"77.287","Armen Gilliam",23,35,12,7,26,"19.8"
"77.290","Herm Gilliam",23,30,7,5,27,"14.1"
"77.293","Artis Gilmore",22,38,16,5,26,"24.6"
"77.297","Walt Gilmore",23,23,0,1,23,"2.1"
"77.300","Chuck Gilmur",24,28,4,2,25,"9.6"
"77.303","Manu Ginobili",25,40,15,1,30,"19.5"
"77.305","Gordan Giricek",25,30,5,6,25,"14.3"
"77.307","Jack Givens",22,23,1,1,22,"7.7"
"77.310","Mickell Gladness",25,25,0,3,25,"3"
"77.313","George Glamack",30,30,0,1,30,"9.3"
"77.316","Gerald Glass",23,28,5,7,24,"Did Not Play (other pro league—Italy)"
"77.320","Mike Glenn",22,31,9,4,29,"8.6"
"77.323","Normie Glick",22,22,0,1,22,"2"
"77.326","Georgi Glouchkov",26,26,0,1,26,"4.9"
"77.328","Clarence Glover",24,24,0,1,24,"2.6"
"77.331","Dion Glover",21,26,5,4,25,"10.1"
"77.334","Andreas Glyniadakis",25,25,0,1,25,"1.3"
"77.336","Mike Gminski",21,34,13,5,29,"17.2"
"77.339","Rudy Gobert",21,25,4,1,24,"14"
"77.341","Dan Godfread",23,24,1,2,23,"1.3"
"77.344","Tom Gola",23,33,10,5,27,"Did Not Play (military service—U.S. Army)"
"77.347","Ben Goldfaden",33,33,0,1,33,"1"
"77.350","Anthony Goldwire",24,34,10,13,26,"Did Not Play (other pro league—Spain)"
"77.353","Ryan Gomes",23,31,8,5,26,"Did Not Play"
"77.356","Glen Gondrezick",22,27,5,2,26,"8.3"
"77.359","Grant Gondrezick",24,26,2,3,24,"Did Not Play (other pro league—France)"
"77.362","Drew Gooden",21,34,13,11,28,"14.8"
"77.365","Gail Goodrich",22,35,13,3,28,"25.9"
"77.368","Steve Goodrich",24,25,1,2,24,"1.6"
"77.371","Archie Goodwin",19,22,3,4,21,"8.9"
"77.374","Pop Goodwin",26,27,1,1,26,"4.7"
"77.376","Aaron Gordon",19,22,3,1,22,"17.6"
"77.379","Ben Gordon",21,31,10,4,23,"21.4"
"77.382","Drew Gordon",24,24,0,1,24,"1.9"
"77.386","Eric Gordon",20,29,9,4,22,"22.3"
"77.389","Lancaster Gordon",22,25,3,1,24,"7.5"
"77.392","Paul Gordon",22,22,0,1,22,"0.8"
"77.395","Marcin Gortat",23,33,10,4,27,"15.4"
"77.397","Leo Gottlieb",26,27,1,1,26,"5.9"
"77.399","Andrew Goudelock",23,27,4,3,23,"Did Not Play"
"77.402","Gerald Govan",26,34,8,4,28,"12.5"
"77.405","Bato Govedarica",25,25,0,1,25,"3.3"
"77.408","Joe Graboski",19,32,13,8,29,"Did Not Play (other pro league—NPBL)"
"77.410","Ricky Grace",26,26,0,1,26,"1.3"
"77.414","Calvin Graham",23,23,0,1,23,"1.6"
"77.417","Greg Graham",23,27,4,5,25,"7"
"77.420","Joey Graham",23,28,5,3,26,"7.7"
"77.424","Mal Graham",22,23,1,1,22,"6"
"77.427","Orlando Graham",23,23,0,1,23,"1.1"
"77.431","Paul Graham",24,26,2,1,24,"10.1"
"77.434","Stephen Graham",23,28,5,8,26,"5.4"
"77.438","Treveon Graham",23,24,1,1,24,"4.3"
"77.441","Jim Grandholm",30,30,0,1,30,"3"
"77.445","Ron Grandison",24,31,7,10,27,"Did Not Play (other pro team—Athletes in Action)"
"77.449","Danny Granger",22,31,9,4,25,"25.8"
"77.453","Stewart Granger",22,25,3,4,22,"Did Not Play (other pro league—CBA)"
"77.456","Brian Grant",22,33,11,5,28,"15.2"
"77.459","Bud Grant",22,23,1,1,22,"2.6"
"77.462","Gary Grant",23,35,12,4,24,"13.1"
"77.465","Greg Grant",23,29,6,8,25,"Did Not Play (other pro league—CBA)"
"77.468","Harvey Grant",23,33,10,4,27,"18.6"
"77.472","Horace Grant",22,38,16,4,28,"15.1"
"77.475","Jerami Grant",20,23,3,3,21,"9.7"
"77.478","Jerian Grant",23,25,2,2,25,"8.4"
"77.481","Josh Grant",26,26,0,1,26,"3"
"77.484","Paul Grant",25,30,5,8,30,"Did Not Play (other pro league—Yugoslavia)"
"77.488","Travis Grant",23,26,3,5,25,"25.2"
"77.491","Don Grate",26,26,0,1,26,"2"
"77.494","Butch Graves",23,23,0,1,23,"1.3"
"77.497","Aaron Gray",23,29,6,5,23,"4.3"
"77.500","Devin Gray",24,27,3,6,24,"Did Not Play (other pro league—Spain)"
"77.503","Ed Gray",22,23,1,1,22,"7.6"
"77.507","Evric Gray",27,27,0,1,27,"2.6"
"77.510","Gary Gray",22,22,0,1,22,"2.4"
"77.513","Josh Gray",24,24,0,1,24,"6.4"
"77.516","Leonard Gray",23,25,2,3,24,"13.8"
"77.519","Stuart Gray",21,27,6,4,24,"3"
"77.522","Sylvester Gray",21,21,0,1,21,"8"
"77.525","Wyndol Gray",24,25,1,4,24,"6.4"
"77.528","Jeff Grayer",23,32,9,7,26,"Did Not Play (other pro league—CBA)"
"77.531","Bob Greacen",22,24,2,2,22,"2.6"
"77.534","A.C. Green",22,37,15,5,30,"14.7"
"77.537","Danny Green",22,30,8,2,27,"11.7"
"77.540","Devin Green",23,23,0,1,23,"0.9"
"77.543","Draymond Green",22,27,5,1,25,"14"
"77.546","Erick Green",23,24,1,3,23,"3.4"
"77.549","Gerald Green",20,32,12,10,28,"Did Not Play (other pro league—Russia)"
"77.551","JaMychal Green",24,27,3,3,27,"10.3"
"77.554","Jeff Green",21,31,10,9,28,"Did Not Play (illness—heart condition)"
"77.557","Johnny Green",26,39,13,7,29,"18.1"
"77.560","Ken Green",26,26,0,1,26,"4.4"
"77.563","Kenny Green",21,22,1,3,21,"5.5"
"77.566","Lamar Green",22,27,5,4,25,"6.7"
"77.569","Litterial Green",22,28,6,5,22,"Did Not Play (other pro league—CBA)"
"77.572","Luther Green",23,26,3,3,23,"Did Not Play"
"77.575","Mike Green",22,28,6,7,23,"17.4"
"77.578","Rickey Green",23,37,14,10,27,"Did Not Play (other pro league—CBA)"
"77.581","Sean Green",21,23,2,4,22,"4.8"
"77.585","Si Green",23,32,9,9,28,"Did Not Play (military service—U.S. Army)"
"77.588","Sidney Green",23,32,9,7,25,"13.5"
"77.591","Steve Green",22,25,3,4,22,"14.9"
"77.594","Taurean Green",21,21,0,3,21,"2.1"
"77.597","Tommie Green",22,22,0,1,22,"3.9"
"77.600","Willie Green",22,33,11,5,26,"12.4"
"77.603","Donte Greene",20,23,3,1,21,"8.5"
"77.606","Orien Greene",23,28,5,6,23,"Did Not Play (other pro league—Netherlands)"
"77.610","Jerry Greenspan",22,23,1,1,22,"4.9"
"77.613","Dave Greenwood",22,33,11,5,22,"16.3"
"77.616","Hal Greer",22,36,14,2,31,"24.1"
"77.619","Lynn Greer",27,27,0,1,27,"4.1"
"77.622","Gary Gregor",23,28,5,6,23,"11.1"
"77.625","Claude Gregory",27,29,2,3,29,"Did Not Play (other pro league—CBA)"
"77.628","John Greig",21,21,0,1,21,"2.1"
"77.631","Norm Grekin",23,23,0,1,23,"0"
"77.634","Kevin Grevey",22,31,9,2,27,"17.2"
"77.637","Dennis Grey",21,22,1,2,21,"9.1"
"77.640","Adrian Griffin",25,33,8,6,27,"7.2"
"77.643","Blake Griffin",21,28,7,3,24,"24.1"
"77.646","Eddie Griffin",19,24,5,3,19,"Did Not Play (rehab—substance abuse)"
"77.649","Greg Griffin",25,25,0,1,25,"4"
"77.652","Paul Griffin",23,29,6,2,26,"6.3"
"77.655","Taylor Griffin",23,23,0,1,23,"1.3"
"77.658","Darrell Griffith",22,32,10,2,26,"Did Not Play (injury—foot)"
"77.661","Chuck Grigsby",26,26,0,1,26,"2.3"
"77.664","Derek Grimm",23,23,0,1,23,"1.6"
"77.667","Woody Grimshaw",27,27,0,1,27,"2.9"
"77.670","Dick Groat",22,22,0,1,22,"11.9"
"77.673","Bob Gross",22,29,7,2,24,"12.7"
"77.677","Mike Grosso",24,24,0,1,24,"4.1"
"77.680","Jerry Grote",24,24,0,1,24,"1.3"
"77.683","Alex Groza",23,24,1,1,23,"23.4"
"77.686","Dick Grubar",22,22,0,1,22,"2"
"77.689","Anthony Grundy",26,26,0,1,26,"4.3"
"77.692","Ernie Grunfeld",22,30,8,3,26,"12.7"
"77.695","Gene Guarilia",22,25,3,1,24,"3.6"
"77.698","Petur Gudmundsson",23,30,7,6,27,"Did Not Play (other pro league—United Kingdom)"
"77.701","Richie Guerin",24,37,13,5,29,"Did Not Play (retired)"
"77.704","Tom Gugliotta",23,35,12,8,27,"20.6"
"77.707","Andres Guibert",25,26,1,1,25,"3"
"77.709","Jay Guidinger",23,24,1,1,23,"1.6"
"77.712","Coulby Gunther",23,25,2,3,23,"Did Not Play (other pro league—PBLA)"
"77.715","Dave Gunther",25,25,0,1,25,"2"
"77.718","Al Guokas",24,24,0,3,24,"4.8"
"77.721","Matt Guokas",31,31,0,1,31,"1.7"
"77.724","Matt Guokas",22,31,9,8,29,"10"
"77.727","Jorge Gutierrez",25,27,2,4,25,"4.1"
"77.730","A.J. Guyton",22,24,2,2,22,"6"
"84.36","Rudy Hackett",22,23,1,4,22,"6.4"
"84.39","Hamed Haddadi",23,27,4,3,27,"4.1"
"84.41","Jim Hadnot",28,28,0,1,28,"17.5"
"84.44","Scott Haffner",23,24,1,2,23,"4.6"
"84.48","Cliff Hagan",25,38,13,3,28,"Did Not Play"
"84.51","Glenn Hagan",26,26,0,1,26,"1.8"
"84.54","Tom Hagan",23,24,1,4,24,"5.6"
"84.57","Robert Hahn",24,24,0,1,24,"1"
"84.60","Al Hairston",23,24,1,1,24,"2.3"
"84.63","Happy Hairston",22,32,10,4,27,"20.6"
"84.66","Lindsay Hairston",24,24,0,1,24,"5.8"
"84.69","Malik Hairston",21,22,1,1,21,"3.3"
"84.72","P.J. Hairston",22,23,1,3,23,"6.9"
"84.75","Marcus Haislip",22,29,7,5,22,"Did Not Play (other pro league—Turkey)"
"84.78","Chick Halbert",27,31,4,7,27,"12.7"
"84.81","Swede Halbrook",28,29,1,1,29,"6.3"
"84.84","Bruce Hale",30,32,2,4,30,"12.6"
"84.87","Hal Hale",22,22,0,1,22,"5"
"84.90","Jack Haley",25,34,9,6,26,"Did Not Play (injury)"
"84.93","Shaler Halimon",23,27,4,6,25,"8.9"
"84.96","Mike Hall",22,22,0,1,22,"1"
"84.99","Jeff Halliburton",22,23,1,3,23,"9.5"
"84.102","Darvin Ham",23,31,8,8,26,"Did Not Play (other pro league—Spain)"
"84.105","Steve Hamer",23,23,0,1,23,"2.2"
"84.108","Dale Hamilton",30,30,0,1,30,"1.8"
"84.111","Daniel Hamilton",22,22,0,1,22,"2"
"84.114","Dennis Hamilton",23,26,3,4,25,"6.3"
"84.117","Joe Hamilton",22,27,5,6,22,"15.7"
"84.120","Jordan Hamilton",21,25,4,5,25,"11.4"
"84.123","Justin Hamilton",23,26,3,6,24,"Did Not Play"
"84.127","Ralph Hamilton",27,27,0,3,27,"6.5"
"84.130","Richard Hamilton",21,34,13,3,27,"20.1"
"84.133","Roy Hamilton",22,23,1,2,22,"4.6"
"84.136","Steve Hamilton",24,25,1,1,25,"5.1"
"84.139","Tang Hamilton",23,23,0,1,23,"2.2"
"84.142","Thomas Hamilton",20,24,4,4,24,"Did Not Play (other pro league—CBA)"
"84.145","Zendon Hamilton",25,30,5,7,26,"6"
"84.148","Geert Hammink",24,26,2,3,25,"4"
"84.151","Julian Hammond",24,28,4,1,27,"13.8"
"84.154","Tom Hammonds",22,33,11,5,24,"11.9"
"84.157","A.J. Hammons",24,24,0,1,24,"2.2"
"84.160","Joe Hamood",24,24,0,1,24,"9.9"
"84.163","Darrin Hancock",23,25,2,5,24,"4.3"
"84.166","Ben Handlogten",30,31,1,1,31,"4.5"
"84.169","Cecil Hankins",25,26,1,2,25,"5.9"
"84.172","Phil Hankinson",22,23,1,1,23,"4"
"84.175","Alex Hannum",26,33,7,7,28,NA
"84.178","Don Hanrahan",23,23,0,1,23,"1.8"
"84.181","Rollen Hans",22,23,1,1,22,"7.2"
"84.184","Ben Hansbrough",25,25,0,1,25,"2"
"84.188","Tyler Hansbrough",24,30,6,3,25,"11"
"84.191","Bob Hansen",23,31,8,4,26,"9.7"
"84.194","Glenn Hansen",23,25,2,3,23,"6.5"
"84.197","Lars Hansen",24,24,0,1,24,"5.1"
"84.200","Travis Hansen",25,25,0,1,25,"3"
"84.204","Reggie Hanson",29,29,0,1,29,"0.8"
"84.207","Bill Hanzlik",23,32,9,2,29,"13"
"84.210","Luke Harangody",23,24,1,3,23,"6.2"
"84.213","Anfernee Hardaway",22,36,14,6,24,"Did Not Play (retired)"
"84.216","Tim Hardaway",23,36,13,7,25,"Did Not Play (injury—knee)"
"84.219","Tim Hardaway",21,25,4,2,25,"17.5"
"84.222","James Harden",20,28,8,2,28,"30.4"
"84.225","Reggie Harding",21,25,4,5,25,"Did Not Play (suspended—legal problems)"
"84.227","Charlie Hardnett",24,26,2,2,24,"10.6"
"84.230","Alan Hardy",23,24,1,2,24,"3.7"
"84.233","Darrell Hardy",NA,NA,NA,1,NA,"5.2"
"84.235","James Hardy",22,25,3,2,22,"6.7"
"84.238","Ira Harge",26,31,5,7,29,"15.4"
"84.241","John Hargis",29,30,1,4,29,"10.7"
"84.244","Maurice Harkless",19,24,5,2,23,"10"
"84.247","Jerry Harkness",23,28,5,3,28,"Did Not Play"
"84.250","Skip Harlicka",22,22,0,1,22,"4.1"
"84.253","Jerome Harmon",25,25,0,1,25,"4.6"
"84.256","Derek Harper",22,37,15,5,29,"19.7"
"84.259","Justin Harper",22,27,5,4,27,"Did Not Play"
"84.262","Mike Harper",23,24,1,1,24,"6.8"
"84.265","Ron Harper",23,37,14,5,26,"23"
"84.268","Matt Harpring",22,32,10,4,26,"17.6"
"84.271","Montrezl Harrell",22,24,2,2,24,"11"
"84.274","Josh Harrellson",22,24,2,3,22,"4.4"
"84.277","Adam Harrington",22,22,0,3,22,"3.2"
"84.281","Al Harrington",18,33,15,8,28,"20.7"
"84.283","Junior Harrington",22,26,4,5,24,"Did Not Play (other pro league—Spain)"
"84.286","Othella Harrington",23,34,11,6,26,"13.1"
"84.289","Art Harris",22,25,3,3,22,"12.4"
"84.292","Bernie Harris",24,24,0,1,24,"0.5"
"84.295","Billy Harris",23,23,0,1,23,"8"
"84.298","Bob Harris",22,26,4,3,24,"7.8"
"84.301","Chris Harris",22,22,0,3,22,"2.7"
"84.304","Devin Harris",21,34,13,6,25,"21.3"
"84.307","Elias Harris",24,24,0,1,24,"0"
"84.310","Gary Harris",20,23,3,1,23,"17.5"
"84.313","Joe Harris",23,26,3,2,26,"10.8"
"84.316","Lucious Harris",23,34,11,4,32,"10.3"
"84.319","Manny Harris",21,27,6,4,24,"Did Not Play"
"84.322","Mike Harris",24,30,6,6,30,"Did Not Play (other pro league—China)"
"84.325","Steve Harris",22,26,4,5,24,"10.3"
"84.328","Terrel Harris",24,25,1,3,24,"3.6"
"84.331","Tobias Harris",19,25,6,5,25,"19.3"
"84.334","Tony Harris",23,27,4,3,26,"Did Not Play (other pro league—CBA)"
"84.338","Aaron Harrison",21,23,2,2,23,"6.7"
"84.341","Andrew Harrison",22,23,1,1,23,"9.5"
"84.344","Bob Harrison",22,30,8,5,27,NA
"84.347","David Harrison",22,25,3,1,22,"6.1"
"84.350","Shaquille Harrison",24,24,0,1,24,"6.6"
"84.353","Jason Hart",22,31,9,11,26,"Did Not Play (other pro league—Greece)"
"84.356","Josh Hart",22,22,0,1,22,"7.9"
"84.359","Antonio Harvey",23,32,9,9,25,"Did Not Play (other pro league—Greece)"
"84.364","Donnell Harvey",20,24,4,6,21,"8"
"84.367","Scott Haskin",23,23,0,1,23,"2"
"84.370","Clem Haskins",24,32,8,3,26,"20.3"
"84.373","Udonis Haslem",23,37,14,1,27,"12"
"84.376","Trenton Hassell",22,30,8,5,26,"9.2"
"84.379","Billy Hassett",28,29,1,4,28,"8.9"
"84.382","Joe Hassett",22,27,5,5,25,"9.1"
"84.385","Scott Hastings",22,32,10,6,28,"5.1"
"84.388","Kirk Haston",22,23,1,2,22,"1.7"
"84.391","Vern Hatton",23,26,3,5,26,NA
"84.394","John Havlicek",22,37,15,1,30,"28.9"
"84.397","Spencer Hawes",19,28,9,7,25,"13.5"
"84.400","Steve Hawes",24,33,9,5,27,"12.7"
"84.403","Bubbles Hawkins",21,24,3,4,22,"19.3"
"84.406","Connie Hawkins",25,33,8,6,26,"30.2"
"84.409","Hersey Hawkins",22,34,12,4,24,"22.1"
"84.412","Juaquin Hawkins",29,29,0,1,29,"2.3"
"84.415","Marshall Hawkins",25,25,0,1,25,"3.9"
"84.418","Michael Hawkins",24,28,4,5,24,"Did Not Play (other pro league—Greece)"
"84.421","Tom Hawkins",23,32,9,3,31,"11.6"
"84.424","Nate Hawthorne",24,26,2,2,26,"6.1"
"84.427","Chuck Hayes",22,32,10,4,27,"7.9"
"84.430","Elvin Hayes",23,38,15,5,25,"28.7"
"84.433","Jarvis Hayes",22,28,6,3,23,"10.2"
"84.437","Jim Hayes",22,22,0,1,22,"3.1"
"84.440","Nigel Hayes",23,23,0,4,23,"3.6"
"84.443","Steve Hayes",26,30,4,7,26,"4.5"
"84.446","Gordon Hayward",20,27,7,2,26,"21.9"
"84.449","Lazar Hayward",24,26,2,2,24,"3.8"
"84.452","Brendan Haywood",22,35,13,6,28,"Did Not Play (injury—stress fracture in right foot)"
"84.455","Spencer Haywood",20,33,13,8,20,"Did Not Play (other pro league—Italy)"
"84.458","John Hazen",21,21,0,1,21,"3"
"84.464","Luther Head",23,28,5,5,24,"10.9"
"84.467","Shane Heal",26,33,7,3,33,"Did Not Play (other pro league—Australia)"
"84.469","Brian Heaney",23,23,0,1,23,"2"
"84.472","Gar Heard",22,32,10,6,25,"15.3"
"84.475","Reggie Hearn",26,26,0,1,26,"1"
"84.478","Herm Hedderick",25,25,0,1,25,"0.8"
"84.481","Alvin Heggs",28,28,0,1,28,"2"
"84.484","Tom Heinsohn",22,30,8,1,27,"22.1"
"84.487","Dick Hemric",22,23,1,1,22,"7"
"84.490","Alan Henderson",23,34,11,4,25,"14.3"
"84.493","Cedric Henderson",21,21,0,3,21,"3"
"84.496","Cedric Henderson",22,26,4,2,22,"10.1"
"84.499","Dave Henderson",23,23,0,1,23,"5.7"
"84.502","Gerald Henderson",24,36,12,8,29,"13.4"
"84.505","Gerald Henderson",22,29,7,4,25,"15.5"
"84.508","J.R. Henderson",22,22,0,1,22,"3.2"
"84.511","Jerome Henderson",26,27,1,2,26,"4"
"84.514","Kevin Henderson",22,23,1,3,23,"4"
"84.517","Tom Henderson",23,31,8,4,24,"14.2"
"84.520","Mark Hendrickson",22,25,3,5,24,"5.5"
"84.523","Larry Hennessy",26,27,1,2,27,"6.4"
"84.526","Don Henriksen",23,25,2,4,23,"Did Not Play (retired)"
"84.529","Al Henry",21,22,1,1,22,"4.3"
"84.532","Bill Henry",24,25,1,3,24,"9.9"
"84.535","Carl Henry",25,25,0,1,25,"2.8"
"84.539","Conner Henry",23,24,1,5,24,"7.8"
"84.542","Myke Henry",25,25,0,1,25,"5.4"
"84.545","Skeeter Henry",26,26,0,1,26,"1"
"84.549","Xavier Henry",19,23,4,3,22,"10"
"84.552","John Henson",22,27,5,1,23,"11.1"
"84.555","Steve Henson",22,30,8,6,24,"Did Not Play (other pro league—Italy)"
"84.558","Charles Hentz",23,23,0,1,23,"6"
"84.561","Bill Herman",25,25,0,1,25,"4.3"
"84.564","Kleggie Hermsen",23,29,6,10,23,"Did Not Play"
"84.567","Juan Hernangomez",21,22,1,1,21,"4.9"
"84.569","Willy Hernangomez",22,23,1,3,22,"8.2"
"84.571","Chris Herren",24,25,1,2,25,"3.3"
"84.575","Carl Herrera",25,32,7,5,30,"8"
"84.579","Walter Herrmann",27,29,2,3,27,"9.2"
"84.581","Keith Herron",22,25,3,4,24,"Did Not Play (other pro league—Belgium)"
"84.584","Sonny Hertzberg",24,28,4,4,27,"10.2"
"84.587","Dan Hester",22,22,0,3,22,"6.1"
"84.590","Fred Hetzel",23,28,5,6,25,"19"
"84.593","Bill Hewitt",24,30,6,6,26,"Did Not Play"
"84.596","Jack Hewson",23,23,0,1,23,"2.7"
"84.599","Art Heyman",22,28,6,9,26,"Did Not Play"
"84.602","Mario Hezonja",20,22,2,1,22,"9.6"
"84.604","Roy Hibbert",22,30,8,5,25,"12.8"
"84.607","Nat Hickey",46,46,0,1,46,"1"
"84.609","Isaiah Hicks",23,23,0,1,23,"4.4"
"84.612","Phil Hicks",24,26,2,5,24,"Did Not Play"
"84.615","J.J. Hickson",20,27,7,6,23,"15.1"
"84.618","Buddy Hield",23,24,1,3,23,"15.1"
"84.621","Bill Higgins",22,22,0,1,22,"9.2"
"84.624","Cory Higgins",22,23,1,1,22,"3.9"
"84.627","Earle Higgins",24,24,0,1,24,"4.4"
"84.630","Mike Higgins",22,23,1,4,22,"2.6"
"84.633","Rod Higgins",23,35,12,8,28,"15.5"
"84.636","Sean Higgins",22,29,7,9,23,"Did Not Play (other pro league—Greece)"
"84.639","Kenny Higgs",24,27,3,3,26,"Did Not Play (other pro league—CBA)"
"84.642","Johnny High",22,26,4,2,23,"Did Not Play"
"84.645","Wayne Hightower",23,32,9,9,30,"18.1"
"84.648","Nene Hilario",20,35,15,4,26,"14.6"
"84.650","Armond Hill",23,30,7,5,25,"10.2"
"84.653","Cleo Hill",23,23,0,1,23,"5.5"
"84.656","Gary Hill",22,23,1,3,22,"5.1"
"84.659","George Hill",22,31,9,6,30,"16.9"
"84.662","Grant Hill",22,40,18,5,27,"Did Not Play (injury—ankle)"
"84.665","Jordan Hill",22,29,7,6,27,"12"
"84.668","Simmie Hill",23,27,4,7,23,"Did Not Play"
"84.671","Solomon Hill",22,26,4,2,23,"8.9"
"84.674","Steven Hill",23,23,0,1,23,"2"
"84.677","Tyrone Hill",22,35,13,6,26,"13.8"
"84.680","Art Hillhouse",30,31,1,1,30,"6"
"84.683","Darrun Hilliard",22,24,2,2,22,"4"
"84.686","Darnell Hillman",22,30,8,7,25,"13.9"
"84.689","Fred Hilton",24,25,1,1,24,"11.6"
"84.692","Kirk Hinrich",23,35,12,4,26,"16.6"
"84.695","Roy Hinson",22,29,7,4,24,"19.6"
"84.698","Mel Hirsch",25,25,0,1,25,"1.5"
"84.701","Lew Hitch",22,27,5,5,24,NA
"84.704","Robert Hite",23,23,0,1,23,"4.3"
"84.707","Darington Hobson",24,24,0,1,24,"0.8"
"84.710","Donald Hodge",22,26,4,3,22,"8.4"
"84.713","Julius Hodge",22,23,1,3,23,"1.8"
"84.716","Craig Hodges",22,31,9,5,25,"10.8"
"84.719","Charlie Hoefer",25,26,1,3,25,"6.1"
"84.722","Paul Hoffman",22,29,7,5,24,"Did Not Play (illness—heart condition)"
"84.725","Bob Hogsett",26,27,1,2,26,"2.3"
"84.728","Paul Hogue",22,23,1,3,22,"7.7"
"84.731","Fred Hoiberg",23,32,9,3,28,"9.1"
"84.734","Doug Holcomb",23,23,0,1,23,"5"
"84.737","Randy Holcomb",26,26,0,1,26,"0.5"
"84.741","Jrue Holiday",19,27,8,2,27,"19"
"84.744","Justin Holiday",23,28,5,7,28,"Did Not Play"
"84.747","Brad Holland",23,25,2,4,25,"4.4"
"84.750","Joe Holland",24,26,2,1,25,"7"
"84.753","John Holland",29,29,0,1,29,"2.3"
"84.756","Wilbur Holland",24,27,3,2,26,"16.6"
"84.759","Lionel Hollins",22,31,9,6,24,"15.9"
"84.762","Ryan Hollins",22,31,9,10,25,"6.1"
"84.765","Essie Hollis",23,23,0,1,23,"2.8"
"84.768","Rondae Hollis-Jefferson",21,23,2,1,23,"13.9"
"84.771","Dennis Holman",22,22,0,1,22,"3.8"
"84.774","Richaun Holmes",22,24,2,1,23,"9.8"
"84.777","Jim Holstein",22,25,3,3,24,NA
"84.780","A.W. Holt",24,24,0,1,24,"0.7"
"84.783","Mike Holton",23,28,5,5,23,"8.4"
"84.786","Dick Holub",26,26,0,1,26,"10.5"
"84.789","Joe Holup",22,24,2,3,24,"8.4"
"84.792","Red Holzman",28,33,5,2,28,"9.1"
"84.795","Jerald Honeycutt",23,24,1,3,23,"6.4"
"84.798","Tyler Honeycutt",21,22,1,1,21,"1.3"
"84.801","Derek Hood",23,23,0,1,23,"0"
"84.804","Rodney Hood",22,25,3,3,25,"16.8"
"84.808","Bobby Hooper",22,22,0,1,22,"5"
"84.811","Carroll Hooser",23,23,0,1,23,"5.6"
"84.814","Tom Hoover",23,28,5,8,28,"Did Not Play (other pro league—EBL)"
"84.817","Bob Hopkins",22,25,3,1,24,"10"
"84.820","Dave Hoppen",23,28,5,6,24,"6.5"
"84.823","Dennis Hopson",22,26,4,4,24,"15.8"
"84.826","Scotty Hopson",24,28,4,3,28,"Did Not Play"
"84.829","Johnny Horan",23,23,0,3,23,"3.1"
"84.832","Cedrick Hordges",24,25,1,1,24,"8.4"
"84.836","Al Horford",21,31,10,2,27,"18.6"
"84.839","Tito Horford",23,28,5,5,23,"Did Not Play (other pro league—Venezuela, Italy)"
"84.842","Ron Horn",23,29,6,4,24,"Did Not Play"
"84.845","Jeff Hornacek",23,36,13,4,28,"20.1"
"84.848","Dennis Horner",23,23,0,1,23,"0.6"
"84.851","Robert Horry",22,37,15,5,25,"12"
"84.854","Ed Horton",22,22,0,1,22,"4.5"
"84.857","Bill Hosket",22,25,3,2,24,"8.1"
"84.860","Bob Houbregs",21,25,4,6,24,NA
"84.863","Danuel House",23,24,1,2,24,"6.6"
"84.866","Eddie House",22,32,10,10,26,"11.1"
"84.869","Allan Houston",22,33,11,2,31,"22.5"
"84.872","Byron Houston",23,26,3,3,23,"5.3"
"84.875","Tom Hovasse",28,28,0,1,28,"0"
"84.878","Brian Howard",24,25,1,1,25,"6.5"
"84.881","Dwight Howard",19,32,13,5,25,"22.9"
"84.883","Greg Howard",23,24,1,2,23,"3.9"
"84.886","Josh Howard",23,32,9,5,27,"19.9"
"84.889","Juwan Howard",21,39,18,10,22,"22.1"
"84.892","Mo Howard",22,22,0,3,22,"5.7"
"84.895","Otis Howard",22,22,0,3,22,"4.5"
"84.898","Stephen Howard",22,27,5,6,26,"Did Not Play (other pro league—Italy)"
"84.901","Bailey Howell",23,34,11,4,24,"23.6"
"84.904","Bob Hubbard",25,26,1,1,25,"5.4"
"84.907","Phil Hubbard",23,32,9,3,28,"15.8"
"84.910","Lester Hudson",25,30,5,7,27,"Did Not Play"
"84.913","Lou Hudson",22,34,12,3,28,"27.1"
"84.916","Troy Hudson",21,31,10,5,26,"14.2"
"84.920","Marcelo Huertas",32,33,1,1,32,"4.5"
"84.922","Josh Huestis",24,26,2,1,25,"7"
"84.925","Nate Huffman",27,27,0,1,27,"3.3"
"84.928","Alfredrick Hughes",23,23,0,1,23,"5.2"
"84.931","Eddie Hughes",27,29,2,2,29,"3.5"
"84.934","Kim Hughes",23,28,5,6,23,"8.2"
"84.937","Larry Hughes",20,33,13,10,21,"Did Not Play (unsigned)"
"84.940","Rick Hughes",26,26,0,1,26,"3.9"
"84.943","Robbie Hummel",24,25,1,1,25,"4.4"
"84.946","John Hummer",22,27,5,4,22,"11.3"
"84.949","Ryan Humphrey",23,25,2,3,25,"2.9"
"84.953","Jay Humphries",22,32,10,5,27,"15.3"
"84.956","Kris Humphries",19,31,12,10,26,"13.8"
"84.959","Hot Rod Hundley",23,28,5,2,25,"12.8"
"84.962","Brandon Hunter",23,24,1,2,23,"3.5"
"84.965","Cedric Hunter",27,27,0,1,27,"0"
"84.968","Chris Hunter",25,25,0,1,25,"4.5"
"84.971","Les Hunter",22,30,8,8,25,"Did Not Play"
"84.974","Lindsey Hunter",23,39,16,5,26,"14.2"
"84.978","Othello Hunter",22,23,1,1,23,"1.6"
"84.981","R.J. Hunter",22,24,2,3,24,"3.8"
"84.984","Steven Hunter",20,28,8,6,25,"Did Not Play"
"84.987","Vince Hunter",23,23,0,1,23,"1.5"
"84.990","Bobby Hurley",22,26,4,3,22,"7.1"
"84.993","Roy Hurley",24,24,0,1,24,"5.2"
"84.996","Geoff Huston",22,29,7,6,23,"16.1"
"84.999","Paul Huston",22,22,0,1,22,"3.6"
"84.1002","Mel Hutchins",23,29,6,3,28,"12.4"
"84.1005","Joe Hutton",22,23,1,1,23,"2.6"
"84.1008","Greg Hyder",22,22,0,1,22,"5.4"
"91.36","Marc Iavaroni",26,32,6,4,28,"6.7"
"91.39","Serge Ibaka",20,28,8,4,24,"15.1"
"91.41","Andre Iguodala",21,34,13,3,24,"19.9"
"91.44","Zydrunas Ilgauskas",22,35,13,3,27,"Did Not Play (injury—foot)"
"91.46","Mile Ilic",22,22,0,1,22,"0"
"91.50","Ersan Ilyasova",19,30,11,8,29,"Did Not Play (other pro league—Spain)"
"91.52","Darrall Imhoff",22,33,11,7,31,"13.6"
"91.55","Tom Ingelsby",22,24,2,3,23,"5"
"91.58","Joe Ingles",27,30,3,1,30,"11.5"
"91.60","Damien Inglis",20,20,0,1,20,"1.8"
"91.62","Andre Ingram",32,32,0,1,32,"12"
"91.65","Brandon Ingram",19,20,1,1,20,"16.1"
"91.68","McCoy Ingram",26,26,0,1,26,"2.8"
"91.71","Ervin Inniger",23,24,1,2,23,"10.6"
"91.74","Byron Irvin",23,26,3,3,26,"Did Not Play (other pro league—CBA)"
"91.78","George Irvine",22,27,5,2,26,"13.1"
"91.81","Kyrie Irving",19,25,6,2,24,"25.2"
"91.84","Jonathan Isaac",20,20,0,1,20,"5.4"
"91.87","Dan Issel",22,36,14,3,23,"30.6"
"91.90","Mike Iuzzolino",24,25,1,1,24,"9.3"
"91.94","Allen Iverson",21,34,13,5,30,"33"
"91.97","Willie Iverson",23,23,0,1,23,"4.9"
"91.100","Royal Ivey",23,32,9,5,26,"5.6"
"91.103","Elvin Ivory",20,20,0,1,20,"4.4"
"91.106","Wesley Iwundu",23,23,0,1,23,"3.7"
"98.36","Warren Jabali",22,28,6,6,23,"22.8"
"98.39","Jarrett Jack",22,34,12,10,28,"15.6"
"98.42","Aaron Jackson",31,31,0,1,31,"8"
"98.45","Al Jackson",24,24,0,1,24,"0"
"98.48","Bobby Jackson",24,35,11,8,29,"15.2"
"98.51","Cedric Jackson",23,23,0,4,23,"3"
"98.55","Darnell Jackson",23,25,2,4,25,"3.2"
"98.58","Demetrius Jackson",22,23,1,4,23,"2.7"
"98.61","Greg Jackson",22,22,0,3,22,"4"
"98.64","Jaren Jackson",22,34,12,10,30,"Did Not Play (other pro league—CBA, WBL)"
"98.67","Jermaine Jackson",23,29,6,7,26,"Did Not Play"
"98.70","Jim Jackson",22,35,13,13,24,"25.7"
"98.73","Josh Jackson",20,20,0,1,20,"13.1"
"98.76","Justin Jackson",22,22,0,1,22,"6.7"
"98.79","Luke Jackson",23,30,7,1,23,"14.8"
"98.82","Luke Jackson",23,26,3,5,26,"5.6"
"98.85","Marc Jackson",26,32,6,6,26,"13.2"
"98.89","Mark Jackson",22,38,16,8,23,"16.9"
"98.92","Mervin Jackson",22,26,4,3,22,"15.7"
"98.95","Michael Jackson",23,25,2,1,23,"2.7"
"98.98","Mike Jackson",23,26,3,4,25,"12.2"
"98.101","Myron Jackson",22,22,0,1,22,"1.4"
"98.104","Phil Jackson",22,34,12,3,28,"Did Not Play (injury—back)"
"98.107","Pierre Jackson",25,25,0,1,25,"4.4"
"98.110","Ralph Jackson",22,22,0,1,22,"2"
"98.113","Randell Jackson",23,24,1,2,23,"4.2"
"98.116","Reggie Jackson",21,27,6,3,25,"18.8"
"98.119","Stanley Jackson",23,23,0,1,23,"2.2"
"98.122","Stephen Jackson",22,35,13,9,31,"21.1"
"98.125","Tony Jackson",25,26,1,5,25,"19.4"
"98.128","Tony Jackson",23,23,0,1,23,"1"
"98.131","Tracy Jackson",22,24,2,4,23,"6.3"
"98.134","Wardell Jackson",23,23,0,1,23,"4.3"
"98.137","Fred Jacobs",24,24,0,1,24,"2.8"
"98.140","Casey Jacobsen",21,26,5,6,23,"Did Not Play (other pro league—Spain)"
"98.143","Sam Jacobson",23,25,2,4,24,"5"
"98.146","Dave Jamerson",23,26,3,5,24,"Did Not Play (injury)"
"98.149","Aaron James",22,26,4,1,25,"12.2"
"98.152","Bernard James",27,29,2,1,27,"2.8"
"98.155","Billy James",23,23,0,1,23,"2"
"98.158","Damion James",23,26,3,3,24,"4.9"
"98.161","Gene James",23,25,2,3,25,"4.7"
"98.164","Henry James",25,32,7,8,25,"Did Not Play (other pro league—CBA)"
"98.168","Jerome James",23,33,10,5,27,"Did Not Play (other pro league—Yugoslavia)"
"98.171","LeBron James",19,33,14,2,21,"31.4"
"98.173","Mike James",26,38,12,13,30,"Did Not Play (other pro league—Turkey)"
"98.176","Mike James",27,27,0,3,27,"10.4"
"98.179","Tim James",23,25,2,3,23,"2.8"
"98.182","Antawn Jamison",22,37,15,7,24,"24.9"
"98.185","Harold Jamison",23,25,2,3,25,"Did Not Play (other pro league—Poland)"
"98.188","John Janisch",26,27,1,4,26,"11.6"
"98.191","Howie Janotta",25,25,0,1,25,"3.4"
"98.194","Marko Jaric",24,30,6,3,26,"9.9"
"98.196","Tony Jaros",26,30,4,3,26,"Did Not Play (other pro league—NBL)"
"98.199","Jim Jarvis",24,25,1,4,25,"7"
"98.202","Sarunas Jasikevicius",29,30,1,3,30,"7.4"
"98.205","Nathan Jawai",22,23,1,2,23,"3.2"
"98.208","Buddy Jeannette",30,32,2,1,30,"10.7"
"98.211","Abdul Jeelani",25,26,1,2,25,"9.6"
"98.214","Chris Jefferies",22,23,1,3,23,"4"
"98.218","Othyus Jeffers",24,28,4,6,25,"Did Not Play"
"98.222","Al Jefferson",20,33,13,6,24,"23.1"
"98.224","Cory Jefferson",24,25,1,2,24,"3.7"
"98.227","Dontell Jefferson",25,25,0,1,25,"4.8"
"98.230","Richard Jefferson",21,37,16,9,27,"22.6"
"98.233","Jared Jeffries",21,31,10,5,23,"6.8"
"98.236","Charles Jenkins",22,23,1,3,22,"5.8"
"98.239","Horace Jenkins",30,30,0,1,30,"2.8"
"98.242","John Jenkins",21,25,4,4,21,"6.1"
"98.245","Brandon Jennings",20,28,8,6,22,"19.1"
"98.247","Keith Jennings",24,26,2,1,24,"8.6"
"98.250","Chris Jent",24,27,3,4,24,"Did Not Play (other pro league—Italy, CBA)"
"98.253","Les Jepsen",23,24,1,2,23,"1.3"
"98.256","Jonas Jerebko",22,30,8,5,22,"Did Not Play (injury—achilles)"
"98.258","Grant Jerrett",21,21,0,3,21,"3"
"98.261","Eugene Jeter",27,27,0,1,27,"4.1"
"98.264","Hal Jeter",24,24,0,1,24,"0.4"
"98.267","Yi Jianlian",20,24,4,4,22,"12"
"98.269","Britton Johnsen",24,25,1,2,24,"2.1"
"98.272","Alexander Johnson",23,24,1,2,23,"4.4"
"98.275","Amir Johnson",18,30,12,4,26,"10.4"
"98.277","Andy Johnson",26,29,3,2,29,"14.3"
"98.280","Anthony Johnson",23,35,12,8,31,"9.2"
"98.283","Armon Johnson",21,22,1,3,22,"5.6"
"98.286","Arnie Johnson",28,32,4,1,31,"10"
"98.289","Avery Johnson",23,38,15,7,29,"13.4"
"98.293","Brice Johnson",22,23,1,3,23,"3"
"98.296","Buck Johnson",23,29,6,2,26,"14.8"
"98.299","Carldell Johnson",29,29,0,1,29,"1.8"
"98.302","Charles Johnson",23,29,6,3,25,"10.9"
"98.305","Cheese Johnson",22,22,0,1,22,"3"
"98.308","Chris Johnson",25,27,2,5,27,"3.9"
"98.311","Chris Johnson",22,25,3,6,24,"6.8"
"98.314","Clay Johnson",25,27,2,2,25,"3.6"
"98.317","Clemon Johnson",22,31,9,5,26,"9.7"
"98.320","Dakari Johnson",22,22,0,1,22,"1.8"
"98.323","Darryl Johnson",30,30,0,1,30,"1.1"
"98.326","Dave Johnson",22,23,1,2,22,"3.7"
"98.329","DeMarco Johnson",24,24,0,1,24,"1.2"
"98.332","Dennis Johnson",22,35,13,3,27,"19.5"
"98.335","DerMarr Johnson",20,27,7,5,21,"Did Not Play (injury—neck)"
"98.338","Ed Johnson",24,26,2,4,25,"14"
"98.341","Eddie Johnson",22,31,9,4,25,"19.1"
"98.344","Eddie Johnson",22,39,17,9,25,"Did Not Play (other pro league—Greece)"
"98.347","Eric Johnson",23,23,0,1,23,"1.1"
"98.351","Ervin Johnson",26,38,12,4,30,"8"
"98.354","Frank Johnson",23,35,12,5,27,"Did Not Play (other pro league—Italy)"
"98.357","George Johnson",23,26,3,3,24,"4.7"
"98.360","George Johnson",24,37,13,8,29,"Did Not Play"
"98.363","George Johnson",22,29,7,5,27,"13"
"98.366","Gus Johnson",25,34,9,4,28,"20.7"
"98.369","Harold Johnson",27,27,0,1,27,"0.6"
"98.372","Ivan Johnson",27,28,1,1,28,"6.6"
"98.376","JaJuan Johnson",22,22,0,1,22,"3.2"
"98.379","James Johnson",22,30,8,6,29,"12.8"
"98.382","Joe Johnson",20,36,16,8,25,"25"
"98.385","John Johnson",23,34,11,5,24,"17"
"98.388","Kannard Johnson",22,22,0,1,22,"0.5"
"98.391","Ken Johnson",23,23,0,1,23,"4.1"
"98.395","Ken Johnson",24,24,0,1,24,"2"
"98.398","Kevin Johnson",21,33,12,4,23,"Did Not Play (retired)"
"98.401","Larry Johnson",23,23,0,1,23,"1.5"
"98.404","Larry Johnson",22,31,9,2,23,"22.1"
"98.407","Lee Johnson",23,23,0,3,23,"1.7"
"98.411","Linton Johnson",23,28,5,8,25,"5.3"
"98.414","Magic Johnson",20,36,16,2,27,"Did Not Play (illness—HIV)"
"98.417","Marques Johnson",21,33,12,4,22,"Did Not Play (injury—neck)"
"98.420","Mickey Johnson",22,33,11,6,27,"19.1"
"98.423","Neil Johnson",23,29,6,3,27,"12.7"
"98.426","Nick Johnson",22,22,0,1,22,"2.6"
"98.429","Ollie Johnson",23,32,9,8,26,"10.1"
"98.432","Omari Johnson",28,28,0,1,28,"5.5"
"98.435","Orlando Johnson",23,26,3,6,26,"Did Not Play"
"98.439","Ralph Johnson",28,31,3,3,28,"9.6"
"98.442","Reggie Johnson",23,26,3,6,24,"12.2"
"98.445","Rich Johnson",22,24,2,5,24,"8"
"98.448","Ron Johnson",22,22,0,3,22,"5.2"
"98.451","Stanley Johnson",19,21,2,1,21,"8.7"
"98.454","Steffond Johnson",24,24,0,1,24,"2.6"
"98.458","Steve Johnson",24,33,9,8,29,"16.8"
"98.461","Stew Johnson",23,31,8,12,28,"22.1"
"98.464","Trey Johnson",24,27,3,6,26,"Did Not Play"
"98.468","Tyler Johnson",22,25,3,1,24,"13.7"
"98.471","Vinnie Johnson",23,35,12,4,26,"15.8"
"98.474","Wesley Johnson",23,30,7,4,27,"9.9"
"98.478","Darius Johnson-Odom",23,24,1,2,23,"0"
"98.481","Nate Johnston",23,23,0,3,23,"2.3"
"98.484","Neil Johnston",22,29,7,1,24,"24.4"
"98.487","Jim Johnstone",22,22,0,3,22,"1.5"
"98.490","Nikola Jokic",20,22,2,1,22,"18.5"
"98.492","Howie Jolliff",22,24,2,1,23,"3.9"
"98.495","Alvin Jones",23,23,0,1,23,"1.1"
"98.498","Anthony Jones",24,27,3,6,24,"Did Not Play (other pro league—CBA)"
"98.502","Askia Jones",23,23,0,1,23,"4.1"
"98.505","Bill Jones",22,22,0,1,22,"3.5"
"98.508","Bobby Jones",23,34,11,3,25,"15.1"
"98.511","Bobby Jones",23,24,1,7,24,"8"
"98.514","Caldwell Jones",23,39,16,10,24,"19.5"
"98.517","Charles Jones",26,40,14,6,27,"5.9"
"98.520","Charles Jones",23,27,4,4,23,"Did Not Play"
"98.523","Charles Jones",23,24,1,2,23,"3.7"
"98.527","Collis Jones",22,25,3,3,23,"11.6"
"98.530","Dahntay Jones",23,36,13,10,35,"Did Not Play"
"98.534","Damian Jones",21,22,1,1,21,"1.9"
"98.537","Damon Jones",22,32,10,11,28,"11.6"
"98.540","DeQuan Jones",22,22,0,1,22,"3.7"
"98.543","Derrick Jones",19,20,1,3,19,"5.3"
"98.546","Dominique Jones",22,24,2,1,24,"4"
"98.549","Dontae' Jones",22,22,0,1,22,"2.9"
"98.553","Dwayne Jones",22,26,4,4,25,"2"
"98.556","Dwight Jones",21,30,9,5,25,"10.6"
"98.559","Earl Jones",24,25,1,2,25,"1.1"
"98.562","Eddie Jones",23,36,13,6,28,"20.1"
"98.565","Edgar Jones",24,29,5,5,27,"10.2"
"98.568","Fred Jones",23,29,6,6,25,"10.6"
"98.571","Hutch Jones",23,24,1,1,23,"4.4"
"98.575","Jake Jones",22,22,0,3,22,"5.2"
"98.578","Jalen Jones",24,24,0,3,24,"5.8"
"98.581","James Jones",23,36,13,5,25,"9.3"
"98.584","Jimmy Jones",23,32,9,4,24,"26.6"
"98.587","Johnny Jones",24,25,1,2,25,"7"
"98.590","Jumaine Jones",20,27,7,6,26,"10.5"
"98.593","K.C. Jones",26,34,8,1,29,"9.2"
"98.596","Kevin Jones",23,23,0,1,23,"3"
"98.599","Larry Jones",22,31,9,7,26,"Did Not Play (other pro league—EBL)"
"98.602","Major Jones",26,31,5,2,29,"5.7"
"98.605","Mark Jones",22,22,0,1,22,"1.2"
"98.608","Mark Jones",29,29,0,1,29,"2.3"
"98.612","Nick Jones",22,27,5,7,25,"Did Not Play"
"98.615","Ozell Jones",24,25,1,2,24,"3.7"
"98.619","Perry Jones",21,23,2,1,23,"4.3"
"98.622","Popeye Jones",23,33,10,6,25,"11.3"
"98.625","Rich Jones",23,30,7,5,26,"22.3"
"98.628","Robin Jones",22,23,1,2,22,"5.5"
"98.631","Sam Jones",24,35,11,1,31,"25.9"
"98.634","Shelton Jones",22,22,0,4,22,"5"
"98.637","Solomon Jones",22,29,7,7,27,"5.5"
"98.640","Steve Jones",25,33,8,9,28,"22.1"
"98.643","Terrence Jones",21,25,4,4,22,"12.1"
"98.646","Tyus Jones",19,21,2,1,21,"5.1"
"98.649","Wah Wah Jones",23,25,2,1,23,"12.5"
"98.652","Wali Jones",22,33,11,7,24,"Did Not Play"
"98.655","Wil Jones",22,30,8,6,24,"14.9"
"98.658","Willie Jones",24,28,4,1,26,"9.2"
"98.661","Adonis Jordan",23,28,5,6,23,"Did Not Play (other pro league—Venezuela)"
"98.664","Charles Jordan",22,22,0,1,22,"5.2"
"98.667","DeAndre Jordan",20,29,9,1,27,"12.7"
"98.670","Eddie Jordan",23,29,6,5,25,"13.3"
"98.673","Jerome Jordan",25,28,3,3,28,"Did Not Play"
"98.676","Michael Jordan",21,39,18,4,23,"Did Not Play (retired)"
"98.679","Reggie Jordan",26,32,6,7,26,"Did Not Play (other pro league—Greece)"
"98.682","Thomas Jordan",24,24,0,1,24,"11"
"98.685","Walter Jordan",24,24,0,1,24,"2.3"
"98.688","Phil Jordon",23,29,6,5,25,"14.3"
"98.691","Johnny Jorgensen",26,27,1,4,26,"4"
"98.694","Noble Jorgensen",21,27,6,7,24,"Did Not Play (other pro league—PCPBL)"
"98.697","Roger Jorgensen",26,26,0,1,26,"1.5"
"98.700","Cory Joseph",20,26,6,3,25,"9.3"
"98.703","Garth Joseph",27,27,0,3,27,"1"
"98.706","Kris Joseph",24,24,0,3,24,"1.2"
"98.709","Yvon Joseph",28,28,0,1,28,"2"
"98.712","Kevin Joyce",22,24,2,4,23,"14.9"
"98.715","Butch Joyner",23,23,0,1,23,"0"
"98.718","Jeff Judkins",22,26,4,4,22,"8.8"
"105.36","Whitey Kachan",23,23,0,3,23,"2.5"
"105.39","George Kaftan",20,24,4,3,20,"14.5"
"105.42","Ed Kalafat",22,24,2,1,24,"8.5"
"105.45","Chris Kaman",21,33,12,5,27,"18.5"
"105.48","Frank Kaminsky",22,24,2,1,23,"11.7"
"105.51","Enes Kanter",19,25,6,4,22,"18.7"
"105.53","Ralph Kaplowitz",27,28,1,3,27,"7.2"
"105.56","Jason Kapono",22,30,8,6,25,"10.9"
"105.59","Tony Kappen",27,27,0,3,27,"7.6"
"105.61","Sergey Karasev",20,22,2,2,21,"4.6"
"105.63","Coby Karl",24,26,2,5,26,"Did Not Play (other pro league—D-League)"
"105.66","George Karl",21,25,4,2,22,"8.1"
"105.69","Ed Kasid",23,23,0,1,23,"1.5"
"105.71","Mario Kasun",24,25,1,1,25,"2.9"
"105.73","Leo Katkaveck",25,26,1,1,26,"4.4"
"105.76","Bob Kauffman",22,28,6,4,24,"20.4"
"105.79","Sasha Kaun",30,30,0,1,30,"0.9"
"105.82","Wilbert Kautz",31,31,0,1,31,"5.1"
"105.85","Clarence Kea",21,22,1,1,21,"7.3"
"105.88","Mike Kearns",25,25,0,1,25,"0.2"
"105.91","Tommy Kearns",22,22,0,1,22,"2"
"105.94","Adam Keefe",22,30,8,3,27,"7.8"
"105.97","Harold Keeling",22,22,0,1,22,"2.2"
"105.100","Bill Keller",22,28,6,1,23,"14.3"
"105.103","Gary Keller",23,24,1,2,23,"7.3"
"105.106","Ken Keller",24,24,0,3,24,"0.9"
"105.109","Rich Kelley",22,32,10,7,25,"15.7"
"105.112","Clark Kellogg",21,25,4,1,21,"20.1"
"105.115","Arvesta Kelly",22,26,4,6,24,"13.7"
"105.118","Jerry Kelly",28,29,1,2,28,"6"
"105.121","Ryan Kelly",22,25,3,2,22,"8"
"105.124","Tom Kelly",24,24,0,1,24,"7.1"
"105.127","Greg Kelser",22,27,5,5,22,"14.2"
"105.130","Ben Kelso",24,24,0,1,24,"1.8"
"105.133","Shawn Kemp",20,33,13,4,29,"20.5"
"105.136","Tim Kempton",23,34,11,12,25,"Did Not Play (other pro league—Italy)"
"105.139","Frank Kendrick",24,24,0,1,24,"3.3"
"105.142","Luke Kennard",21,21,0,1,21,"7.6"
"105.145","D.J. Kennedy",22,22,0,1,22,"6"
"105.148","Goo Kennedy",22,27,5,5,23,"12.5"
"105.151","Joe Kennedy",22,24,2,2,22,"6.2"
"105.154","Pickles Kennedy",22,22,0,1,22,"1.7"
"105.157","Larry Kenon",21,30,9,7,26,"22.1"
"105.160","Billy Kenville",23,29,6,4,26,"Did Not Play (other pro league—EBA)"
"105.163","Jonathan Kerner",24,24,0,1,24,"0"
"105.167","Red Kerr",22,33,11,3,26,"17.8"
"105.170","Steve Kerr",23,37,14,7,28,"8.6"
"105.173","Jack Kerris",25,28,3,4,26,"10.5"
"105.176","Jerome Kersey",22,38,16,6,25,"19.2"
"105.179","Tom Kerwin",23,23,0,1,23,"1.1"
"105.182","Alec Kessler",24,27,3,1,24,"6.2"
"105.185","Lari Ketner",22,23,1,4,22,"1.7"
"105.188","Julius Keye",23,28,5,2,24,"14.7"
"105.191","Randolph Keys",22,29,7,8,23,"Did Not Play (other pro league—Italy)"
"105.194","Viktor Khryapa",22,25,3,2,23,"5.8"
"105.196","Jason Kidd",21,39,18,5,29,"18.7"
"105.199","Warren Kidd",23,23,0,1,23,"3.6"
"105.202","Michael Kidd-Gilchrist",19,24,5,2,22,"12.7"
"105.205","Irv Kiffin",28,28,0,1,28,"3.2"
"105.208","Jack Kiley",23,24,1,1,23,"2.5"
"105.211","Earnie Killum",22,22,0,1,22,"0.3"
"105.214","Carl Kilpatrick",23,23,0,1,23,"1.5"
"105.217","Sean Kilpatrick",25,28,3,7,28,"15.4"
"105.220","Toby Kimball",24,32,8,6,25,"11"
"105.223","Bo Kimble",24,26,2,2,24,"6.9"
"105.227","Stan Kimbrough",23,26,3,4,26,"Did Not Play (other pro league—CBA)"
"105.231","Chad Kinch",22,22,0,3,22,"3.2"
"105.234","Albert King",22,32,10,6,23,"Did Not Play (other pro league—Israel)"
"105.237","Bernard King",21,36,15,7,28,"Did Not Play (injury)"
"105.240","Chris King",24,29,5,6,26,"Did Not Play (other pro league—Turkey)"
"105.243","Dan King",24,24,0,1,24,"1.6"
"105.246","Frankie King",23,24,1,2,24,"2.9"
"105.249","George King",23,29,6,3,25,"Did Not Play (retired)"
"105.252","Gerard King",26,28,2,2,27,"5.3"
"105.255","Jim King",22,31,9,5,26,"16.6"
"105.258","Jimmy King",22,23,1,2,22,"4.5"
"105.261","Loyd King",22,23,1,2,22,"6.6"
"105.264","Maurice King",24,27,3,3,24,"Did Not Play (other pro league—ABL)"
"105.267","Reggie King",22,27,5,2,23,"14.9"
"105.270","Rich King",22,25,3,1,22,"2.2"
"105.273","Ron King",22,22,0,1,22,"7.1"
"105.276","Stacey King",23,30,7,6,27,"11.8"
"105.279","Tom King",22,22,0,1,22,"5.1"
"105.282","Bob Kinney",28,29,1,3,29,"11.1"
"105.285","Tarence Kinsey",22,24,2,2,22,"7.7"
"105.288","Andrei Kirilenko",20,33,13,4,22,"Did Not Play (other pro league—Russia)"
"105.290","Alex Kirk",23,23,0,1,23,"0.8"
"105.293","Walt Kirk",24,27,3,7,24,"Did Not Play (other pro league—NPBL)"
"105.296","Wilber Kirkland",NA,NA,NA,1,NA,"3"
"105.298","Jim Kissane",22,22,0,1,22,"3"
"105.301","Doug Kistler",23,23,0,1,23,"1.6"
"105.304","Curtis Kitchen",23,23,0,1,23,"1.5"
"105.307","Greg Kite",22,33,11,8,26,"5.1"
"105.310","Kerry Kittles",22,30,8,3,23,"Did Not Play (injury—knee)"
"105.313","Maxi Kleber",26,26,0,1,26,"5.4"
"105.315","Joe Kleine",24,38,14,8,26,"9.8"
"105.319","Linas Kleiza",21,28,7,3,26,"Did Not Play (other pro league—Greece)"
"105.322","Leo Klier",25,26,1,1,25,"7.4"
"105.325","Herm Klotz",26,26,0,1,26,"1.4"
"105.328","Duane Klueh",24,25,1,3,24,"10"
"105.331","Lonnie Kluttz",25,25,0,1,25,"0"
"105.334","Billy Knight",22,32,10,7,23,"28.1"
"105.337","Bob Knight",25,25,0,1,25,"3.5"
"105.339","Brandin Knight",23,23,0,1,23,"0"
"105.342","Brandon Knight",20,25,5,4,24,"19.6"
"105.345","Brevin Knight",22,33,11,10,30,"12.6"
"105.348","Negele Knight",23,31,8,8,26,"Did Not Play (other pro league—Switzerland)"
"105.351","Ron Knight",23,24,1,1,24,"5.2"
"105.354","Toby Knight",22,26,4,2,24,"Did Not Play (injury—knee)"
"105.357","Travis Knight",22,28,6,3,23,"6.5"
"105.360","Lee Knorek",25,28,3,2,25,"7.8"
"105.363","Dick Knostman",22,22,0,1,22,"2.6"
"105.366","Rod Knowles",22,22,0,3,22,"1.1"
"105.369","Bart Kofoed",23,28,5,5,28,"Did Not Play (other pro league—Belgium)"
"105.373","Don Kojis",25,36,11,6,30,"22.5"
"105.376","Milo Komenich",29,29,0,1,29,"9.9"
"105.379","Howard Komives",23,32,9,5,25,"15.7"
"105.382","Jon Koncak",22,32,10,2,22,"8.3"
"105.385","Tom Kondla",22,22,0,3,22,"3.4"
"105.388","Bud Koper",22,22,0,1,22,"4.6"
"105.391","Joe Kopicki",22,24,2,2,22,"3.9"
"105.394","Furkan Korkmaz",20,20,0,1,20,"1.6"
"105.396","Frank Kornet",23,24,1,1,23,"2"
"105.399","Luke Kornet",22,22,0,1,22,"6.7"
"105.402","Yaroslav Korolev",18,19,1,1,19,"1.2"
"105.404","Kyle Korver",22,36,14,6,25,"14.4"
"105.407","Tony Koski",22,22,0,1,22,"1.2"
"105.410","Len Kosmalski",23,24,1,2,24,"2.2"
"105.413","Andy Kostecka",27,27,0,1,27,"6.4"
"105.416","Harold Kottman",24,24,0,1,24,"3.1"
"105.419","Kosta Koufos",19,28,9,6,23,"8"
"105.422","Tom Kozelko",22,24,2,2,22,"2.9"
"105.425","Ronald Kozlicki",23,23,0,1,23,"2.9"
"105.428","Arvid Kramer",23,23,0,1,23,"2"
"105.431","Barry Kramer",22,27,5,5,22,"Did Not Play"
"105.434","Joel Kramer",23,27,4,1,23,"5.9"
"105.437","Steven Kramer",23,25,2,3,24,"14"
"105.440","Dan Kraus",25,25,0,1,25,"1.6"
"105.443","Herb Krautblatt",22,22,0,1,22,"1.3"
"105.446","Viacheslav Kravtsov",25,26,1,2,25,"3.1"
"105.448","Jim Krebs",22,28,6,2,26,"10"
"105.451","Wayne Kreklow",24,24,0,1,24,"1.2"
"105.454","Tommy Kron",23,26,3,3,24,"9.7"
"105.457","Tom Kropp",22,23,1,2,23,"3.3"
"105.460","Nenad Krstic",21,27,6,4,23,"16.4"
"105.462","Larry Krystkowiak",22,32,10,8,24,"Did Not Play (other pro league—France)"
"105.465","Steve Kuberski",22,30,8,4,23,"9.3"
"105.468","Leo Kubiak",22,22,0,1,22,"11.5"
"105.471","Bruce Kuczenski",22,22,0,4,22,"2.8"
"105.474","Frank Kudelka",24,27,3,6,26,"9.3"
"105.477","John Kuester",22,24,2,3,22,"4.8"
"105.480","Ray Kuka",25,26,1,1,25,"5.2"
"105.483","Toni Kukoc",25,37,12,5,32,"19.7"
"105.485","Kevin Kunnert",22,30,8,5,24,"12.9"
"105.488","Terry Kunze",24,24,0,1,24,"5"
"105.491","Mitch Kupchak",22,31,9,3,23,"Did Not Play (injury—knee)"
"105.494","C.J. Kupec",23,25,2,2,24,"4.7"
"105.497","Rob Kurz",23,23,0,1,23,"3.9"
"105.500","Ibo Kutluay",30,30,0,1,30,"0"
"105.502","Kyle Kuzma",22,22,0,1,22,"16.1"
"105.505","Ognjen Kuzmic",23,24,1,1,24,"1.3"
"105.507","Mindaugas Kuzminskas",27,28,1,1,27,"6.3"
"112.36","Skal Labissiere",20,21,1,1,20,"8.8"
"112.39","Reggie Lacefield",23,23,0,1,23,"3"
"112.42","Edgar Lacey",24,24,0,1,24,"5.1"
"112.45","Sam Lacey",22,34,12,6,25,"14.2"
"112.48","Bob Lackey",23,24,1,1,23,"6"
"112.51","Fred LaCour",22,24,2,2,23,"7.8"
"112.54","Wendell Ladner",22,26,4,6,22,"17"
"112.57","Christian Laettner",23,35,12,7,23,"18.2"
"112.60","Oliver Lafayette",25,25,0,1,25,"7"
"112.63","Raef LaFrentz",22,31,9,5,25,"14.9"
"112.66","Tom LaGarde",22,29,7,5,25,"Did Not Play (other pro league—Italy)"
"112.69","Bill Laimbeer",23,36,13,3,27,"17.5"
"112.72","Pete Lalich",26,26,0,1,26,"0"
"112.75","Bo Lamar",22,25,3,5,23,"20.9"
"112.78","Doron Lamb",21,22,1,3,22,"3.6"
"112.81","Jeremy Lamb",20,25,5,2,25,"12.9"
"112.84","John Lambert",23,29,6,4,27,"5.4"
"112.87","Jeff Lamp",22,29,7,7,26,"Did Not Play (other pro league—Italy)"
"112.90","Maciej Lampe",18,20,2,5,18,"4.6"
"112.92","Jim Lampley",26,26,0,1,26,"3"
"112.96","Sean Lampley",23,24,1,2,23,"4.8"
"112.99","Carl Landry",24,32,8,6,26,"18"
"112.102","Marcus Landry",24,24,0,3,24,"2.6"
"112.105","Mark Landsberger",22,28,6,4,24,"8.4"
"112.109","Jerome Lane",22,26,4,5,24,"7.5"
"112.112","Andrew Lang",22,33,11,8,29,"12.9"
"112.115","Antonio Lang",22,27,5,6,23,"2.8"
"112.118","James Lang",23,23,0,1,23,"1"
"112.120","Trajan Langdon",23,25,2,1,24,"6"
"112.123","Keith Langford",24,24,0,1,24,"1"
"112.126","Dan Langhi",23,26,3,5,26,"3.5"
"112.129","Bob Lanier",22,35,13,3,23,"25.7"
"112.132","Stu Lantz",22,29,7,6,24,"20.6"
"112.135","Nicolas Laprovittola",27,27,0,1,27,"3.3"
"112.137","York Larese",23,23,0,3,23,"5.4"
"112.140","Shane Larkin",21,25,4,5,23,"Did Not Play"
"112.143","Rusty LaRue",24,30,6,5,26,"Did Not Play (other pro league—Russia)"
"112.146","Rudy LaRusso",22,31,9,3,30,"21.8"
"112.149","John Laskowski",22,23,1,1,22,"9.2"
"112.152","Stephane Lasme",25,25,0,3,25,"5.5"
"112.155","Dave Lattin",24,29,5,5,28,"Did Not Play"
"112.158","Priest Lauderdale",23,24,1,2,24,"3.7"
"112.161","Rich Laurel",23,23,0,1,23,"2.4"
"112.164","Harry Laurie",26,26,0,1,26,"1.4"
"112.167","Walt Lautenbach",27,27,0,1,27,"4.3"
"112.170","Joffrey Lauvergne",23,26,3,5,24,"7.9"
"112.172","Tony Lavelli",23,24,1,2,23,"8.8"
"112.175","Zach LaVine",19,22,3,2,21,"18.9"
"112.178","Bob Lavoy",24,27,3,4,25,"10.3"
"112.181","Acie Law",23,26,3,6,25,"6.2"
"112.184","Gani Lawal",22,22,0,1,22,"0"
"112.187","Edmund Lawrence",28,28,0,1,28,"4"
"112.190","Jason Lawson",23,23,0,1,23,"1.5"
"112.193","Ty Lawson",22,29,7,5,26,"17.6"
"112.196","Jake Layman",22,23,1,1,22,"2.2"
"112.199","Mo Layton",23,29,6,7,23,"Did Not Play"
"112.202","T.J. Leaf",20,20,0,1,20,"2.9"
"112.205","Manny Leaks",23,28,5,9,24,"18.8"
"112.208","Hal Lear",22,22,0,1,22,"1.3"
"112.211","Allen Leavell",22,31,9,1,25,"14.8"
"112.214","Jeff Lebo",23,23,0,1,23,"1.5"
"112.217","Eric Leckner",22,30,8,8,24,"Did Not Play (other pro league—Italy)"
"112.220","Ricky Ledo",21,22,1,3,22,"7.4"
"112.222","Butch Lee",22,23,1,4,22,"11.5"
"112.225","Clyde Lee",22,31,9,5,23,"11.9"
"112.228","Courtney Lee",23,32,9,8,24,"12.5"
"112.231","Damion Lee",25,25,0,1,25,"10.7"
"112.235","David Lee",25,26,1,2,25,"6.9"
"112.238","David Lee",22,33,11,6,26,"20.2"
"112.241","Dick Lee",NA,NA,NA,1,NA,"0"
"112.243","Doug Lee",27,30,3,3,27,"Did Not Play (other pro league—Croatia)"
"112.247","George Lee",24,31,7,3,24,"Did Not Play (coach—assistant coach)"
"112.250","Greg Lee",23,24,1,2,23,"3.6"
"112.253","Keith Lee",23,26,3,3,23,"Did Not Play (injury—leg)"
"112.256","Kurk Lee",23,23,0,1,23,"1.4"
"112.260","Malcolm Lee",21,24,3,3,22,"Did Not Play"
"112.263","Rock Lee",26,26,0,1,26,"1"
"112.267","Ron Lee",24,29,5,5,25,"12.2"
"112.270","Russ Lee",23,25,2,2,25,"4.3"
"112.273","Ed Leede",22,23,1,1,22,"8.9"
"112.276","Hank Lefkowitz",23,23,0,1,23,"2.1"
"112.279","Tim Legler",23,33,10,9,26,"Did Not Play (other pro league—USBL, CBA)"
"112.282","George Lehmann",25,31,6,9,26,"18.9"
"112.285","Walt Lemon, Jr.",25,25,0,1,25,"3.4"
"112.288","Alex Len",20,24,4,1,22,"9"
"112.291","Voshon Lenard",22,32,10,5,29,"14.3"
"112.294","Leary Lentz",22,23,1,3,22,"10.7"
"112.297","Gary Leonard",22,24,2,2,24,"2"
"112.300","Kawhi Leonard",20,26,6,1,25,"25.5"
"112.303","Meyers Leonard",20,25,5,1,23,"8.4"
"112.306","Slick Leonard",24,30,6,4,29,"16.1"
"112.309","Jim Les",25,31,6,5,27,"7.2"
"112.313","Travis Leslie",21,21,0,1,21,"1.4"
"112.316","Ronnie Lester",22,27,5,2,23,"11.6"
"112.319","Clifford Lett",24,25,1,2,25,"4.9"
"112.322","Jon Leuer",22,28,6,6,27,"10.2"
"112.325","Andrew Levane",28,32,4,5,29,"Did Not Play (other pro league—ABL)"
"112.328","Fat Lever",22,33,11,4,28,"Did Not Play (injury)"
"112.331","Caris LeVert",22,23,1,1,23,"12.1"
"112.334","Cliff Levingston",22,34,12,6,27,"Did Not Play (other pro league—Italy)"
"112.337","Bobby Lewis",22,25,3,2,24,"7.2"
"112.340","Cedric Lewis",26,26,0,1,26,"1.3"
"112.343","Freddie Lewis",28,29,1,4,28,"11.4"
"112.346","Freddie Lewis",23,33,10,6,31,"22.6"
"112.349","Grady Lewis",29,31,2,4,30,"7.1"
"112.352","Martin Lewis",20,21,1,1,20,"4.7"
"112.356","Mike Lewis",22,27,5,6,23,"16.2"
"112.359","Quincy Lewis",22,26,4,3,24,"Did Not Play"
"112.362","Ralph Lewis",24,26,2,3,26,"3.3"
"112.365","Rashard Lewis",19,34,15,5,27,"22.4"
"112.367","Reggie Lewis",22,27,5,1,26,"20.8"
"112.370","Marcus Liberty",22,25,3,3,23,"9.3"
"112.373","Todd Lichti",23,27,4,5,24,"14"
"112.376","Barry Liebowitz",22,22,0,4,22,"11.5"
"112.379","DeAndre Liggins",23,29,6,9,28,"Did Not Play"
"112.382","Bill Ligon",22,22,0,1,22,"3.3"
"112.385","Goose Ligon",23,29,6,4,23,"16.2"
"112.387","Damian Lillard",22,27,5,1,26,"27"
"112.390","Jeremy Lin",22,29,7,6,29,"18"
"112.393","Steve Lingenfelter",24,25,1,2,24,"1.1"
"112.397","Alton Lister",23,39,16,7,28,"Did Not Play (other pro league—Italy)"
"112.400","Samuel Little",23,23,0,1,23,"1.7"
"112.403","Gene Littles",26,31,5,2,26,"12.5"
"112.406","Randy Livingston",21,31,10,9,23,"12"
"112.409","Shaun Livingston",19,32,13,11,21,"Did Not Play (injury—knee)"
"112.411","Ron Livingstone",24,25,1,3,24,"9.6"
"112.414","Horacio Llamas Grey",23,24,1,1,24,"3"
"112.417","Bobby Lloyd",22,23,1,2,23,"9.9"
"112.420","Chuck Lloyd",23,23,0,1,23,"4.7"
"112.423","Earl Lloyd",22,31,9,4,26,"Did Not Play (military service—U.S. Army)"
"112.426","Lewis Lloyd",22,30,8,6,24,"Did Not Play (other pro league—CBA)"
"112.429","Scott Lloyd",24,30,6,7,28,"Did Not Play (other pro league—Italy)"
"112.432","Riney Lochmann",23,25,2,1,24,"4.9"
"112.435","Bob Lochmueller",25,25,0,1,25,"3.7"
"112.438","Rob Lock",22,22,0,1,22,"1.5"
"112.441","Darrell Lockhart",23,23,0,1,23,"2"
"112.444","Ian Lockhart",23,23,0,1,23,"4"
"112.447","Kevin Loder",22,24,2,3,22,"6.9"
"112.451","Don Lofgran",21,24,3,5,23,"7.4"
"112.454","Henry Logan",22,23,1,2,22,"12.5"
"112.457","John Logan",26,30,4,2,28,"14.1"
"112.460","Brad Lohaus",23,33,10,9,25,"10"
"112.463","Art Long",28,30,2,5,29,"4.5"
"112.466","Grant Long",22,36,14,7,25,"14.8"
"112.469","John Long",22,40,18,7,25,"Did Not Play (other pro league—CBA)"
"112.472","Paul Long",23,26,3,3,26,"4.5"
"112.475","Shawn Long",24,24,0,1,24,"8.2"
"112.478","Willie Long",21,23,2,2,23,"12.6"
"112.481","Luc Longley",23,32,9,5,29,"11.4"
"112.484","Kevon Looney",19,21,2,1,21,"4"
"112.487","Brook Lopez",20,29,9,3,25,"20.7"
"112.490","Felipe Lopez",24,27,3,4,24,"9.3"
"112.493","Raul Lopez",23,24,1,1,23,"7"
"112.495","Robin Lopez",20,29,9,5,29,"11.8"
"112.498","Ryan Lorthridge",22,22,0,1,22,"7.4"
"112.501","Jim Loscutoff",25,33,8,1,26,"10.6"
"112.504","Plummer Lott",22,23,1,1,22,"2.5"
"112.507","Kevin Loughery",22,32,10,4,28,"22.6"
"112.511","Bob Love",24,34,10,6,29,"25.8"
"112.514","Kevin Love",20,29,9,2,25,"26.1"
"112.517","Stan Love",22,25,3,4,22,"7.9"
"112.520","Clyde Lovellette",24,34,10,4,28,"23.4"
"112.523","Sidney Lowe",24,30,6,8,24,"Did Not Play (other pro league—CBA)"
"112.526","Charlie Lowery",22,22,0,1,22,"2.3"
"112.529","Kyle Lowry",20,31,11,4,30,"22.4"
"112.532","Al Lucas",26,26,0,1,26,"1"
"112.535","Jerry Lucas",23,33,10,4,25,"21.5"
"112.538","John Lucas",23,36,13,6,33,"17.5"
"112.541","Kalin Lucas",25,25,0,1,25,"0"
"112.544","Maurice Lucas",22,35,13,9,23,"20.4"
"112.547","John Lucas III",23,34,11,10,29,"Did Not Play (other pro league—Italy)"
"112.551","Ted Luckenbill",22,23,1,2,23,"3.1"
"112.554","Tyronn Lue",21,31,10,8,27,"13.5"
"112.557","Jim Luisi",25,25,0,1,25,"2.9"
"112.560","Al Lujack",26,26,0,1,26,"0.8"
"112.563","Phil Lumpkin",23,24,1,2,23,"4.2"
"112.566","Ray Lumpp",25,29,4,4,25,"13.5"
"112.569","Timothe Luwawu-Cabarrot",21,22,1,1,21,"6.4"
"112.571","Tyler Lydon",21,21,0,1,21,"0"
"112.574","Trey Lyles",20,22,2,2,22,"9.9"
"112.577","R.B. Lynam",NA,NA,NA,1,NA,"2.4"
"112.579","George Lynch",23,34,11,5,23,"9.6"
"112.582","Kevin Lynch",23,24,1,1,23,"4.1"
"112.585","Lonnie Lynn",26,26,0,3,26,"5.3"
"112.588","Mike Lynn",24,25,1,2,24,"2.7"
"119.36","Sheldon Mac",24,24,0,1,24,"3"
"119.39","Mike Macaluso",22,22,0,1,22,"1.6"
"119.42","Ed Macauley",21,30,9,3,22,"20.4"
"119.45","Todd MacCulloch",24,27,3,2,26,"9.7"
"119.48","Ronnie MacGilvray",24,24,0,1,24,"1.3"
"119.51","Scott Machado",22,22,0,1,22,"1.3"
"119.54","Arvydas Macijauskas",26,26,0,1,26,"2.3"
"119.56","Ollie Mack",22,24,2,4,23,"10.2"
"119.59","Sam Mack",22,31,9,8,28,"Did Not Play (other pro league—Venezuela)"
"119.64","Shelvin Mack",21,27,6,6,25,"12.7"
"119.67","Malcolm Mackey",23,23,0,1,23,"1.5"
"119.70","Rudy Macklin",23,25,2,2,23,"7"
"119.73","Vernon Macklin",25,25,0,1,25,"2"
"119.77","Johnny Macknowswki",27,28,1,1,27,"7.4"
"119.80","Don MacLean",23,31,8,7,24,"18.2"
"119.83","Mark Macon",22,29,7,4,22,"Did Not Play"
"119.86","Kyle Macy",23,29,6,3,24,"14.2"
"119.90","Jack Maddox",29,29,0,1,29,"0"
"119.93","Tito Maddox",21,21,0,1,21,"1.2"
"119.96","Gerald Madkins",24,28,4,4,28,"Did Not Play (other pro league—France)"
"119.99","Mark Madsen",25,33,8,2,28,"3.6"
"119.102","Norm Mager",24,24,0,1,24,"5.2"
"119.105","Josh Magette",28,28,0,1,28,"2.6"
"119.108","Corey Maggette",20,33,13,6,25,"22.2"
"119.111","Dave Magley",23,23,0,1,23,"0.9"
"119.114","Jamaal Magloire",22,33,11,9,25,"13.6"
"119.117","Randolph Mahaffey",22,25,3,4,23,"13.8"
"119.120","Ian Mahinmi",21,31,10,5,29,"Did Not Play"
"119.122","John Mahnken",24,30,6,8,26,"10"
"119.125","Brian Mahoney",24,24,0,1,24,"3.1"
"119.128","Mo Mahoney",25,26,1,2,25,"2"
"119.131","Rick Mahorn",22,40,18,5,23,"Did Not Play (other pro league—Italy)"
"119.134","Dan Majerle",23,36,13,3,26,"17.3"
"119.137","Renaldo Major",24,24,0,1,24,"5"
"119.141","Thon Maker",19,20,1,1,20,"4.8"
"119.143","Lionel Malamed",24,24,0,3,24,"6.5"
"119.146","Jeff Malone",22,34,12,5,28,"24.3"
"119.149","Karl Malone",22,40,18,2,26,"31"
"119.152","Moses Malone",19,39,20,10,26,"31.1"
"119.154","Matt Maloney",25,31,6,4,25,"Did Not Play (injury)"
"119.158","Steve Malovic",23,23,0,4,23,"2.6"
"119.162","Mike Maloy",21,23,2,2,21,"7.2"
"119.165","Ted Manakas",22,22,0,1,22,"2.4"
"119.168","John Mandic",29,30,1,4,29,"4.8"
"119.171","Frank Mangiapane",21,21,0,1,21,"0.8"
"119.174","Danny Manning",22,36,14,8,27,"23.7"
"119.177","Ed Manning",24,32,8,7,30,"8.3"
"119.180","Guy Manning",23,24,1,1,23,"9"
"119.183","Rich Manning",25,26,1,3,25,"3.7"
"119.187","Pace Mannion",23,28,5,7,25,"4.5"
"119.190","Nick Mantis",24,27,3,5,27,"Did Not Play (other pro league—ABL)"
"119.193","Pete Maravich",23,32,9,5,29,"31.1"
"119.196","Press Maravich",26,26,0,1,26,"4.6"
"119.199","Devyn Marble",22,23,1,1,22,"2.3"
"119.202","Roy Marble",23,27,4,3,23,"Did Not Play (other pro league—CBA)"
"119.205","Stephon Marbury",19,31,12,6,23,"23.9"
"119.208","Sarunas Marciulionis",25,32,7,5,27,"Did Not Play (injury)"
"119.210","Saul Mariaschin",23,23,0,1,23,"7.7"
"119.213","Jack Marin",22,32,10,5,27,"22.3"
"119.216","Shawn Marion",21,36,15,6,27,"21.8"
"119.219","Boban Marjanovic",27,29,2,4,29,"6.2"
"119.221","Lauri Markkanen",20,20,0,1,20,"15.2"
"119.224","Damir Markota",21,21,0,1,21,"1.7"
"119.226","Sean Marks",23,35,12,8,26,"Did Not Play (other pro league—Poland)"
"119.229","Harvey Marlatt",22,24,2,1,23,"5"
"119.232","Jim Marsh",25,25,0,1,25,"3.1"
"119.235","Ricky Marsh",23,23,0,1,23,"4.5"
"119.238","Donny Marshall",23,30,7,4,24,"Did Not Play (other pro league—CBA, Greece)"
"119.241","Donyell Marshall",21,35,14,9,30,"16.2"
"119.244","Kendall Marshall",21,24,3,4,22,"8"
"119.247","Rawle Marshall",23,24,1,2,23,"3.1"
"119.251","Tom Marshall",24,28,4,5,24,"Did Not Play (military service)"
"119.254","Vester Marshall",25,25,0,1,25,"1.3"
"119.257","Bill Martin",23,25,2,3,23,"5"
"119.260","Bob Martin",24,25,1,1,24,"2.1"
"119.263","Brian Martin",23,23,0,3,23,"0.8"
"119.266","Cartier Martin",24,30,6,7,27,"9.3"
"119.269","Cuonzo Martin",24,25,1,2,24,"2.3"
"119.272","Darrick Martin",23,36,13,8,25,"Did Not Play (other pro league—Italy, Russia)"
"119.275","Dino Martin",26,27,1,1,26,"12.2"
"119.278","Don Martin",26,28,2,3,26,"3.5"
"119.281","Fernando Martin",24,24,0,1,24,"0.9"
"119.283","Jarell Martin",21,23,2,1,23,"7.7"
"119.286","Jeff Martin",23,24,1,1,24,"7.1"
"119.289","Kenyon Martin",23,37,14,5,25,"16.7"
"119.292","Kevin Martin",21,32,11,6,25,"24.6"
"119.295","LaRue Martin",22,25,3,1,24,"7"
"119.298","Maurice Martin",22,23,1,1,22,"3.4"
"119.301","Phil Martin",26,26,0,1,26,"1.7"
"119.304","Slater Martin",24,34,10,4,29,"13.6"
"119.307","Whitey Martin",22,22,0,1,22,"3.4"
"119.310","Jamal Mashburn",21,31,10,5,22,"24.1"
"119.313","Al Masino",24,25,1,4,24,"5.5"
"119.316","Anthony Mason",23,36,13,7,30,"Did Not Play (injury)"
"119.319","Desmond Mason",23,32,9,6,27,"17.2"
"119.322","Frank Mason",23,23,0,1,23,"7.9"
"119.325","Roger Mason",22,33,11,10,28,"Did Not Play (other pro league—Israel)"
"119.328","Tony Massenburg",23,37,14,15,31,"Did Not Play (other pro league—Spain)"
"119.331","Eddie Mast",22,24,2,2,24,"2.8"
"119.334","Mangok Mathiang",25,25,0,1,25,"2"
"119.337","Johnny Mathis",24,24,0,1,24,"3.4"
"119.340","Wes Matthews",21,30,9,8,21,"Did Not Play (other pro league—CBA)"
"119.343","Wesley Matthews",23,31,8,3,27,"16.4"
"119.346","Ariel Maughan",23,27,4,5,25,"10.8"
"119.349","Marlon Maxey",23,24,1,1,23,"5.4"
"119.353","Jason Maxiell",22,31,9,3,24,"7.9"
"119.356","Cedric Maxwell",22,32,10,4,23,"19"
"119.359","Vernon Maxwell",23,35,12,9,26,"17.2"
"119.362","Don May",23,29,6,6,25,"20.2"
"119.365","Scott May",22,28,6,3,22,"14.6"
"119.368","Sean May",21,25,4,3,22,"Did Not Play"
"119.371","Lee Mayberry",22,28,6,2,24,"5.8"
"119.374","Clyde Mayes",22,23,1,5,22,"4.4"
"119.377","Tharon Mayes",23,23,0,3,23,"4.3"
"119.380","Bill Mayfield",23,23,0,1,23,"2.4"
"119.383","Ken Mayfield",27,27,0,1,27,"2.8"
"119.386","Eric Maynor",22,26,4,6,25,"6.9"
"119.389","O.J. Mayo",21,28,7,3,21,"18.5"
"119.392","Travis Mays",22,24,2,2,22,"14.3"
"119.395","Matt Mazza",26,26,0,1,26,"3.8"
"119.398","Luc Mbah a Moute",22,31,9,7,28,"9.9"
"119.401","Bob McAdoo",21,34,13,8,23,"34.5"
"119.404","James Michael McAdoo",22,25,3,2,22,"4.1"
"119.407","Ken McBride",NA,NA,NA,1,NA,"9.8"
"119.409","Ray McCallum",22,24,2,4,23,"7.4"
"119.412","Bob McCann",25,33,8,7,28,"Did Not Play (other pro league—France)"
"119.416","Brendan McCann",22,24,2,1,22,"1.9"
"119.419","Mel McCants",22,22,0,1,22,"1.7"
"119.422","Rashad McCants",21,24,3,3,23,"14.9"
"119.425","Mike McCarron",24,27,3,6,24,"Did Not Play (other pro league—PBLA, ABL)"
"119.428","Andre McCarter",23,27,4,3,23,"Did Not Play (other pro league—CBA)"
"119.431","Willie McCarter",23,25,2,2,23,"7.7"
"119.434","Johnny McCarthy",22,29,7,6,24,"Did Not Play (other pro league—ABL)"
"119.437","Howie McCarty",NA,NA,NA,1,NA,"1.1"
"119.439","Kelly McCarty",23,23,0,1,23,"2"
"119.442","Walter McCarty",22,31,9,5,23,"9.6"
"119.445","Amal McCaskill",23,30,7,8,28,"Did Not Play (other pro league—Spain)"
"119.448","Patrick McCaw",21,22,1,1,21,"4"
"119.451","Dwayne McClain",22,22,0,1,22,"3.5"
"119.454","Ted McClain",25,32,7,8,27,"13.1"
"119.457","Dan McClintock",23,23,0,1,23,"3"
"119.460","Jack McCloskey",27,27,0,1,27,"6"
"119.463","George McCloud",22,34,12,7,28,"Did Not Play (other pro league—Italy)"
"119.466","CJ McCollum",22,26,4,1,25,"23"
"119.469","John McConathy",21,21,0,1,21,"1.3"
"119.472","Bucky McConnell",24,24,0,1,24,"4.9"
"119.475","T.J. McConnell",23,25,2,1,24,"6.9"
"119.479","Keith McCord",23,23,0,1,23,"2"
"119.483","Tim McCormick",22,29,7,7,25,"14.1"
"119.486","Jelani McCoy",21,30,9,8,25,"Did Not Play (other pro league—Spain)"
"119.489","Paul McCracken",22,26,4,3,26,"Did Not Play"
"119.492","Chris McCray",22,22,0,1,22,"0"
"119.495","Rodney McCray",22,31,9,4,28,"16.6"
"119.498","Scooter McCray",23,26,3,3,26,"Did Not Play (other pro league—France)"
"119.501","Erik McCree",24,24,0,1,24,"0"
"119.504","Chris McCullough",20,22,2,3,20,"4.7"
"119.507","John McCullough",25,25,0,1,25,"2.6"
"119.510","Clint McDaniel",23,23,0,1,23,"2.5"
"119.513","Xavier McDaniel",22,34,12,7,23,"Did Not Play (other pro league—Greece)"
"119.516","Jim McDaniels",23,29,6,7,23,"Did Not Play"
"119.519","K.J. McDaniels",21,23,2,4,21,"9.2"
"119.522","Doug McDermott",23,26,3,5,25,"10.2"
"119.525","Ben McDonald",23,26,3,2,25,"7.6"
"119.528","Glenn McDonald",22,24,2,2,23,"5.6"
"119.531","Michael McDonald",28,28,0,1,28,"0"
"119.535","Roderick McDonald",25,27,2,1,25,"4"
"119.538","Hank McDowell",22,27,5,6,24,"3.6"
"119.541","Antonio McDyess",21,36,15,7,24,"Did Not Play (injury—knee)"
"119.544","Jim McElroy",22,28,6,4,25,"16.9"
"119.547","Patrick McFarland",22,24,2,3,24,"12"
"119.550","Ivan McFarlin",24,24,0,1,24,"1.4"
"119.553","Mel McGaha",22,22,0,1,22,"3.5"
"119.556","Mitch McGary",22,23,1,1,22,"6.3"
"119.559","JaVale McGee",21,30,9,6,24,"11.9"
"119.562","Mike McGee",22,30,8,6,28,"14.2"
"119.565","Bill McGill",23,30,7,11,24,"Did Not Play"
"119.568","George McGinnis",21,31,10,5,24,"29.8"
"119.571","Jon McGlocklin",22,32,10,3,25,"19.6"
"119.574","Tracy McGrady",18,32,14,7,23,"32.1"
"119.576","Gil McGregor",22,22,0,1,22,"4.1"
"119.579","Elton McGriff",25,26,1,4,26,"7.3"
"119.582","Rodney McGruder",25,26,1,1,25,"6.4"
"119.585","Alfred McGuire",23,26,3,2,24,"6.1"
"119.588","Allie McGuire",22,22,0,1,22,"2"
"119.591","Dick McGuire",24,34,10,2,26,"9.2"
"119.594","Dominic McGuire",22,27,5,8,23,"4.5"
"119.598","Kevin McHale",23,35,12,1,29,"26.1"
"119.601","Maurice McHartley",25,27,2,5,25,"15.3"
"119.604","Jim McIlvaine",22,28,6,3,24,"3.8"
"119.607","Jeff McInnis",22,33,11,9,27,"Did Not Play (other pro league—CBA)"
"119.610","Kenny McIntosh",23,26,3,3,25,"7.4"
"119.613","Bob McIntyre",24,26,2,3,24,"Did Not Play"
"119.616","Jerry McKee",23,23,0,1,23,"0"
"119.619","Kevin McKenna",23,29,6,5,28,"Did Not Play (other pro league—CBA)"
"119.622","Forrest McKenzie",23,23,0,1,23,"2.8"
"119.625","Stan McKenzie",23,29,6,5,27,"13.8"
"119.628","Derrick McKey",21,35,14,3,22,"15.9"
"119.631","Aaron McKie",22,34,12,5,29,"12.2"
"119.634","Billy McKinney",23,30,7,7,26,"Did Not Play"
"119.637","Bones McKinney",28,33,5,3,30,"12.7"
"119.640","Carlton McKinney",25,27,2,3,25,"Did Not Play (other pro league—Italy)"
"119.644","Trey McKinney-Jones",27,27,0,1,27,"0"
"119.647","Alfonzo McKinnie",25,25,0,1,25,"1.5"
"119.650","Ben McLemore",20,24,4,2,21,"12.1"
"119.653","McCoy McLemore",22,29,7,8,25,"12.7"
"119.656","George McLeod",22,22,0,1,22,"1.2"
"119.659","Keith McLeod",24,27,3,5,25,"7.8"
"119.662","Roshown McLeod",23,25,2,3,25,"9.9"
"119.666","Jack McMahon",24,31,7,3,25,"10"
"119.669","Nate McMillan",22,33,11,1,23,"7.6"
"119.672","Tom McMillen",23,33,10,5,25,"9.9"
"119.675","Jim McMillian",22,30,8,4,24,"18.9"
"119.678","Shellie McMillon",22,25,3,3,25,"11.8"
"119.681","Mal McMullen",22,23,1,1,22,"5.6"
"119.684","Chet McNabb",27,27,0,1,27,"0"
"119.687","Mark McNamara",23,31,8,7,24,"Did Not Play (other pro league—Italy)"
"119.691","Joe McNamee",24,25,1,3,25,"4.5"
"119.694","Jerel McNeal",27,27,0,1,27,"1.5"
"119.697","Chris McNealy",24,26,2,1,24,"5.7"
"119.700","Bob McNeill",22,23,1,4,22,"5.8"
"119.703","Larry McNeill",23,28,5,7,27,"11.9"
"119.706","Carl McNulty",24,24,0,1,24,"2"
"119.709","Paul McPherson",22,22,0,3,22,"6.8"
"119.712","Roy McPipe",24,24,0,1,24,"4.2"
"119.715","Cozell McQueen",25,25,0,1,25,"2"
"119.718","Jordan McRae",24,25,1,3,24,"5.3"
"119.721","Thales McReynolds",22,22,0,1,22,"0.6"
"119.724","Josh McRoberts",20,30,10,8,25,"9.3"
"119.727","Eric McWilliams",22,22,0,1,22,"2"
"119.730","George Mearns",24,25,1,1,24,"6.7"
"119.733","Stanislav Medvedenko",21,27,6,2,24,"8.3"
"119.735","Darnell Mee",22,23,1,1,22,"1.9"
"119.738","Jodie Meeks",22,30,8,7,26,"15.7"
"119.741","Cliff Meely",24,28,4,3,24,"9.9"
"119.744","Scott Meents",26,27,1,1,26,"2.1"
"119.747","Dick Mehen",27,29,2,6,27,"14.4"
"119.750","Monk Meineke",22,27,5,4,22,"Did Not Play (retired)"
"119.753","Carl Meinhold",21,22,1,4,22,"6.3"
"119.756","Salah Mejri",29,31,2,1,29,"3.7"
"119.758","Gal Mekel",25,26,1,2,25,"2.4"
"119.761","Bill Melchionni",22,31,9,3,27,"Did Not Play (other league—EPBL)"
"119.764","Gary Melchionni",23,24,1,1,24,"8.5"
"119.767","Fab Melo",22,22,0,1,22,"1.2"
"119.770","Ed Melvin",30,30,0,1,30,"4.9"
"119.773","Dean Meminger",23,28,5,2,25,"8.3"
"119.776","Chuck Mencel",22,23,1,1,23,"9.2"
"119.779","John Mengelt",22,31,9,6,25,"11"
"119.782","Ken Menke",27,27,0,1,27,"2.5"
"119.785","Pops Mensah-Bonsu",23,27,4,7,25,"Did Not Play"
"119.788","Dewitt Menyard",23,23,0,1,23,"9.1"
"119.791","Ron Mercer",21,28,7,8,24,"19.7"
"119.794","Joe Meriweather",22,31,9,6,23,"11.1"
"119.797","Porter Meriwether",22,22,0,1,22,"3.8"
"119.800","Tom Meschery",23,32,9,3,24,"16"
"119.803","Bill Meyer",24,24,0,1,24,"3.1"
"119.806","Loren Meyer",23,26,3,5,24,"Did Not Play (injury)"
"119.809","Dave Meyers",22,26,4,2,24,"Did Not Play (injury—back)"
"119.812","Stan Miasek",23,29,6,6,23,"Did Not Play (other pro league—NPBL)"
"119.814","Larry Micheaux",23,24,1,4,24,"4.2"
"119.817","Jordan Mickey",21,23,2,2,23,"4"
"119.820","Khris Middleton",21,26,5,2,26,"20.1"
"119.823","Red Mihalik",30,30,0,1,30,"0.9"
"119.825","Chris Mihm",21,29,8,5,26,"Did Not Play (injury—ankle)"
"119.828","Ed Mikan",23,28,5,7,23,"9.9"
"119.831","George Mikan",24,31,7,2,26,"Did Not Play (retired)"
"119.834","Larry Mikan",22,22,0,1,22,"3"
"119.837","Vern Mikkelsen",21,30,9,1,26,"18.7"
"119.840","Al Miksis",21,21,0,1,21,"3.4"
"119.843","Aaron Miles",22,22,0,1,22,"0.8"
"119.846","C.J. Miles",18,30,12,4,27,"13.5"
"119.848","Darius Miles",19,27,8,6,24,"Did Not Play (injury—knee)"
"119.850","Eddie Miles",23,31,8,4,25,"19.6"
"119.853","Marko Milic",20,21,1,1,20,"2.8"
"119.855","Darko Milicic",18,27,9,7,25,"8.8"
"119.857","Nat Militzok",23,23,0,3,23,"4.8"
"119.860","Andre Miller",23,39,16,10,31,"17"
"119.863","Anthony Miller",23,33,10,7,23,"Did Not Play (other pro league—CBA)"
"119.866","Bill Miller",24,24,0,3,24,"2.8"
"119.869","Bob Miller",27,27,0,1,27,"2"
"119.872","Brad Miller",22,35,13,7,28,"15.6"
"119.875","Darius Miller",22,27,5,3,27,"Did Not Play"
"119.878","Dick Miller",22,22,0,3,22,"1.3"
"119.881","Eddie Miller",21,22,1,3,21,"11.6"
"119.884","Harry Miller",23,23,0,1,23,"2.9"
"119.887","Jay Miller",24,27,3,5,25,"12.5"
"119.890","Larry Miller",22,28,6,6,25,"18.4"
"119.893","Malcolm Miller",24,24,0,1,24,"2.5"
"119.896","Mike Miller",20,36,16,8,26,"18.5"
"119.899","Oliver Miller",22,33,11,9,25,"Did Not Play (other pro league—Poland)"
"119.902","Quincy Miller",20,22,2,4,21,"4.9"
"119.905","Reggie Miller",22,39,17,1,24,"24.6"
"119.908","Walt Miller",31,31,0,1,31,"1.9"
"119.911","Chris Mills",24,33,9,3,30,"16.1"
"119.915","John Mills",27,27,0,1,27,"3.9"
"119.918","Patty Mills",21,29,8,2,23,"10.3"
"119.921","Terry Mills",23,33,10,6,26,"17.3"
"119.924","Elijah Millsap",27,29,2,2,27,"5.3"
"119.928","Paul Millsap",21,32,11,3,31,"18.1"
"119.931","Harold Miner",21,24,3,2,22,"10.5"
"119.934","Yao Ming",22,30,8,2,26,"Did Not Play (injury—foot)"
"119.936","Dirk Minniefield",25,27,2,5,26,"7.7"
"119.939","Dave Minor",29,30,1,3,29,"8.3"
"119.942","Greg Minor",23,27,4,1,24,"9.6"
"119.945","Mark Minor",22,22,0,1,22,"1.3"
"119.948","Nikola Mirotic",23,26,3,3,26,"16.8"
"119.950","Wat Misaka",24,24,0,1,24,"2.3"
"119.953","Jason Miskiri",24,24,0,1,24,"0"
"119.956","Donovan Mitchell",21,21,0,1,21,"20.5"
"119.959","Leland Mitchell",26,26,0,1,26,"4.1"
"119.962","Mike Mitchell",23,32,9,3,25,"24.5"
"119.965","Murray Mitchell",26,26,0,1,26,"1"
"119.968","Sam Mitchell",26,38,12,2,27,"14.6"
"119.971","Todd Mitchell",22,22,0,3,22,"5.4"
"119.974","Tony Mitchell",24,24,0,1,24,"2"
"119.977","Tony Mitchell",21,21,0,1,21,"1"
"119.980","Naz Mitrou-Long",24,24,0,1,24,"3"
"119.983","Steve Mix",22,35,13,7,27,"Did Not Play (other pro league—CBA)"
"119.986","Bill Mlkvy",22,22,0,1,22,"5.8"
"119.989","Cuttino Mobley",23,33,10,5,26,"21.7"
"119.992","Eric Mobley",24,26,2,3,25,"5.4"
"119.995","Doug Moe",29,33,4,4,29,"24.2"
"119.998","Larry Moffett",23,23,0,1,23,"0.8"
"119.1001","Leo Mogus",25,29,4,8,27,"Did Not Play (other pro league—AAPBL)"
"119.1004","Nazr Mohammed",21,38,17,9,23,"12.3"
"119.1007","Jerome Moiso",22,26,4,7,24,"4"
"119.1010","Paul Mokeski",23,34,11,6,24,"7.1"
"119.1013","Jack Molinas",22,22,0,1,22,"11.6"
"119.1016","Wayne Molis",23,24,1,4,24,"5.4"
"119.1019","Sidney Moncrief",22,33,11,3,25,"Did Not Play (retired)"
"119.1022","Eric Money",19,24,5,4,22,"18.6"
"119.1025","Sergei Monia",22,22,0,3,22,"3.3"
"119.1027","Malik Monk",19,19,0,1,19,"6.7"
"119.1030","Earl Monroe",23,35,12,3,24,"25.8"
"119.1033","Greg Monroe",20,27,7,5,22,"16"
"119.1036","Rodney Monroe",23,23,0,1,23,"3.4"
"119.1039","Luis Montero",22,24,2,3,22,"Did Not Play"
"119.1042","Howie Montgomery",22,22,0,1,22,"7.2"
"119.1045","Eric Montross",23,30,7,7,23,"10"
"119.1048","Jamario Moon",27,31,4,6,27,"8.5"
"119.1051","Jim Mooney",22,22,0,1,22,"7.5"
"119.1054","Andre Moore",23,23,0,3,23,"2.9"
"119.1057","Ben Moore",22,22,0,1,22,"0"
"119.1060","E'Twaun Moore",22,28,6,4,28,"12.5"
"119.1063","Gene Moore",23,29,6,7,24,"17.7"
"119.1066","Jackie Moore",22,24,2,4,22,NA
"119.1069","Johnny Moore",22,31,9,4,27,"Did Not Play (other pro league—Mexico)"
"119.1072","Larry Moore",NA,NA,NA,1,NA,"2.3"
"119.1073","Lowes Moore",23,25,2,3,24,"11.3"
"119.1076","Mikki Moore",23,36,13,11,31,"Did Not Play"
"119.1079","Otto Moore",22,30,8,6,23,"11.9"
"119.1082","Richard Moore",NA,NA,NA,1,NA,"3.8"
"119.1084","Ron Moore",26,26,0,3,26,"2.8"
"119.1088","Tracy Moore",26,31,5,4,30,"Did Not Play (other pro league—CBA)"
"119.1091","Eric Moreland",23,26,3,3,26,"Did Not Play"
"119.1094","Jackie Moreland",22,31,9,3,30,"Did Not Play"
"119.1097","Guy Morgan",22,22,0,1,22,"1.9"
"119.1100","Rex Morgan",22,23,1,1,22,"3.4"
"119.1103","Elmore Morgenthaler",24,26,2,3,26,"Did Not Play (other pro league—PBLA, ABL)"
"119.1106","Darren Morningstar",24,24,0,3,24,"4.3"
"119.1110","Chris Morris",23,33,10,3,24,"14.8"
"119.1113","Darius Morris",21,24,3,6,23,"6.9"
"119.1116","Isaiah Morris",23,23,0,1,23,"2.2"
"119.1119","Jaylen Morris",22,22,0,1,22,"4.7"
"119.1122","Marcus Morris",22,28,6,5,26,"14.1"
"119.1125","Markieff Morris",22,28,6,3,25,"15.3"
"119.1128","Max Morris",24,24,0,1,24,"12.6"
"119.1131","Monte Morris",22,22,0,1,22,"3.3"
"119.1134","Randolph Morris",21,24,3,2,22,"3.1"
"119.1137","Terence Morris",23,27,4,4,23,"Did Not Play (other pro league—Greece)"
"119.1140","Adam Morrison",22,25,3,4,22,"Did Not Play (injury—knee)"
"119.1143","John Morrison",22,22,0,1,22,"3"
"119.1146","Mike Morrison",22,22,0,1,22,"2"
"119.1149","Red Morrison",22,25,3,3,22,"Did Not Play"
"119.1152","Anthony Morrow",23,31,8,8,25,"13.2"
"119.1155","Dwayne Morton",23,23,0,1,23,"4.1"
"119.1158","John Morton",22,24,2,3,23,"5.4"
"119.1161","Richard Morton",22,22,0,1,22,"3"
"119.1164","Glenn Mosley",22,23,1,2,23,"3.3"
"119.1167","Perry Moss",27,28,1,4,27,"4.6"
"119.1170","Lawrence Moten",23,25,2,2,24,"6.7"
"119.1173","Donatas Motiejunas",22,26,4,2,24,"12"
"119.1175","Johnathan Motley",22,22,0,1,22,"8.7"
"119.1178","Hanno Mottola",24,25,1,1,25,"4.8"
"119.1181","Arnett Moultrie",22,23,1,1,22,"3.7"
"119.1185","Rick Mount",24,28,4,5,28,"17.1"
"119.1188","Alonzo Mourning",22,37,15,5,25,"Did Not Play (illness—kidney disease)"
"119.1191","Timofey Mozgov",24,31,7,6,28,"10.6"
"119.1193","Chuck Mrazovich",26,26,0,1,26,"3.4"
"119.1196","Emmanuel Mudiay",19,21,2,3,19,"12.8"
"119.1198","Erwin Mueller",22,29,7,7,22,"12.7"
"119.1201","Shabazz Muhammad",21,25,4,3,22,"13.5"
"119.1204","Joe Mullaney",25,25,0,1,25,"0.8"
"119.1207","Bob Mullens",24,24,0,3,24,"8.5"
"119.1210","Byron Mullens",20,24,4,5,23,"10.6"
"119.1213","Chris Mullin",22,37,15,2,25,"26.5"
"119.1216","Jeff Mullins",22,33,11,3,26,"22.8"
"119.1219","Todd Mundt",25,25,0,3,25,"1.3"
"119.1223","Xavier Munford",23,25,2,3,23,"Did Not Play"
"119.1226","Chris Munk",23,23,0,1,23,"1.2"
"119.1229","George Munroe",25,26,1,2,25,"7"
"119.1232","Eric Murdock",23,31,8,8,25,"15.3"
"119.1235","Gheorghe Muresan",22,28,6,3,24,"Did Not Play (injury)"
"119.1237","Allen Murphy",23,24,1,2,23,"3.9"
"119.1240","Calvin Murphy",22,34,12,2,29,"25.6"
"119.1243","Dick Murphy",25,25,0,3,25,"1.3"
"119.1246","Erik Murphy",23,23,0,1,23,"0.3"
"119.1249","Jay Murphy",22,25,3,2,24,"3.4"
"119.1252","John Murphy",22,22,0,3,22,"2.7"
"119.1254","Kevin Murphy",22,22,0,1,22,"0.9"
"119.1257","Ronnie Murphy",23,23,0,1,23,"2"
"119.1260","Tod Murphy",24,30,6,7,26,"Did Not Play (other pro league—Spain)"
"119.1263","Troy Murphy",21,32,11,7,24,"15.4"
"119.1266","Dejounte Murray",20,21,1,1,21,"8.1"
"119.1269","Jamal Murray",19,20,1,1,20,"16.7"
"119.1272","Ken Murray",22,26,4,5,22,"Did Not Play (military service)"
"119.1275","Lamond Murray",21,32,11,5,28,"Did Not Play (injury)"
"119.1278","Ronald Murray",23,30,7,9,26,"13.5"
"119.1282","Tracy Murray",21,32,11,8,24,"16.2"
"119.1285","Willie Murrell",26,28,2,4,26,"16.4"
"119.1288","Dorie Murrey",23,28,5,5,24,"7.3"
"119.1291","Toure' Murry",24,25,1,4,24,"2.7"
"119.1294","Mike Muscala",22,26,4,1,26,"7.6"
"119.1297","Angelo Musi",28,30,2,1,28,"9.4"
"119.1300","Jerrod Mustaf",21,24,3,2,23,"4.6"
"119.1303","Dikembe Mutombo",25,42,17,7,25,"16.6"
"119.1306","Martin Muursepp",22,23,1,3,23,"5.7"
"119.1308","Pete Myers",23,34,11,9,30,"Did Not Play (other pro league—Italy)"
"126.36","Hamady N'Diaye",24,27,3,3,24,"Did Not Play"
"126.39","Makhtar N'Diaye",25,25,0,1,25,"1.3"
"126.43","Mamadou N'Diaye",25,29,4,5,27,"5.5"
"126.46","Boniface N'Dong",28,28,0,1,28,"2.2"
"126.48","Bob Naber",23,23,0,1,23,"0.3"
"126.51","Boris Nachamkin",21,21,0,1,21,"3.3"
"126.54","Bostjan Nachbar",22,27,5,5,27,"9.8"
"126.56","Abdel Nader",24,24,0,1,24,"3"
"126.60","Jerry Nagel",21,21,0,1,21,"0.9"
"126.63","Fritz Nagy",25,25,0,1,25,"5.1"
"126.66","Lee Nailon",25,30,5,8,29,"14.2"
"126.70","Eduardo Najera",24,35,11,6,28,"6.9"
"126.73","Larry Nance",22,34,12,3,27,"22.5"
"126.76","Larry Nance",23,25,2,3,25,"8.9"
"126.79","Shabazz Napier",23,26,3,3,26,"8.7"
"126.82","Paul Napolitano",25,25,0,1,25,"0"
"126.85","Bob Nash",22,28,6,4,28,"Did Not Play"
"126.88","Cotton Nash",22,25,3,5,25,"Did Not Play"
"126.91","Steve Nash",22,39,17,3,31,"18.8"
"126.94","Swen Nater",24,34,10,8,31,"15.6"
"126.97","Howard Nathan",24,24,0,1,24,"2.6"
"126.101","Calvin Natt",23,33,10,6,28,"23.3"
"126.104","Kenny Natt",22,26,4,5,24,"Did Not Play (other pro league—CBA)"
"126.107","Willie Naulls",22,31,9,5,27,"25"
"126.110","Juan Carlos Navarro",27,27,0,1,27,"10.9"
"126.112","Maurice Ndour",24,24,0,1,24,"3.1"
"126.115","Craig Neal",24,26,2,5,26,"Did Not Play (other pro league—CBA)"
"126.118","Gary Neal",26,32,6,8,30,"11.8"
"126.122","Jim Neal",23,24,1,2,23,"4.7"
"126.125","Lloyd Neal",22,28,6,1,25,"15.5"
"126.128","Ed Nealy",22,32,10,7,22,"Did Not Play (other pro league—CBA)"
"126.131","Nemanja Nedovic",22,22,0,1,22,"1.1"
"126.133","Al Negratti",25,25,0,1,25,"2.8"
"126.136","Barry Nelson",22,22,0,1,22,"1.3"
"126.139","DeMarcus Nelson",23,23,0,1,23,"4.1"
"126.142","Don Nelson",22,35,13,3,29,"15.4"
"126.145","Jameer Nelson",22,35,13,7,26,"16.7"
"126.148","Louie Nelson",22,26,4,6,24,"12.5"
"126.151","Ron Nelson",24,24,0,1,24,"3.2"
"126.154","Ruben Nembhard",24,24,0,3,24,"4"
"126.157","Dick Nemelka",27,27,0,1,27,"5.5"
"126.160","Tyrone Nesby",23,26,3,3,24,"13.3"
"126.163","Martin Nessley",22,22,0,3,22,"1.2"
"126.166","Rasho Nesterovic",22,33,11,4,26,"11.2"
"126.168","Raul Neto",23,25,2,1,23,"5.9"
"126.170","Bob Netolicky",25,33,8,4,27,"20.6"
"126.173","Johnny Neumann",20,26,6,10,21,"19.6"
"126.176","Paul Neumann",24,29,5,4,27,"14.4"
"126.179","Chuck Nevitt",23,34,11,9,23,"Did Not Play (other pro league—USBL)"
"126.182","Melvin Newbern",25,25,0,1,25,"3.6"
"126.185","Ivano Newbill",24,27,3,4,27,"Did Not Play (other pro league—CBA)"
"126.188","Ira Newble",26,33,7,6,27,"8"
"126.191","Mike Newlin",23,33,10,3,32,"21.4"
"126.194","Johnny Newman",23,38,15,8,27,"16.9"
"126.197","Dave Newmark",22,24,2,3,24,"7.5"
"126.200","Bill Newton",22,23,1,1,22,"2.4"
"126.203","Georges Niang",23,24,1,2,24,"1"
"126.206","Demetris Nichols",23,24,1,4,24,"2.5"
"126.209","Jack Nichols",22,31,9,6,26,"Did Not Play (military service—U.S. Marine Corps)"
"126.212","Andrew Nicholson",23,27,4,4,23,"7.8"
"126.215","Gaylon Nickerson",27,27,0,3,27,"4.3"
"126.221","Carl Nicks",22,24,2,4,23,"7.4"
"126.224","Rich Niemann",22,25,3,7,23,"11.3"
"126.227","Richie Niemiera",27,28,1,3,27,"6.6"
"126.230","Mike Niles",25,25,0,1,25,"2.6"
"126.233","Kurt Nimphius",23,31,8,7,27,"Did Not Play (other pro league—Spain)"
"126.236","Dyron Nix",22,22,0,1,22,"2"
"126.239","Norm Nixon",22,33,11,5,24,"Did Not Play (injury—knee)"
"126.242","Joakim Noah",22,32,10,2,28,"12.6"
"126.245","Chuck Noble",24,30,6,2,28,"11.3"
"126.248","Andres Nocioni",25,32,7,4,27,"14.1"
"126.250","David Noel",22,22,0,1,22,"2.7"
"126.253","Nerlens Noel",20,23,3,3,21,"11.1"
"126.256","Paul Noel",23,27,4,2,24,"3.8"
"126.259","Lucas Nogueira",22,25,3,1,24,"4.4"
"126.261","Jim Nolan",22,22,0,1,22,"1.6"
"126.264","Paul Nolen",24,24,0,1,24,"0"
"126.267","Jeff Nordgaard",24,24,0,1,24,"1.4"
"126.270","Bevo Nordmann",22,25,3,5,23,"10.7"
"126.273","Johnny Norlander",25,29,4,1,25,"10.4"
"126.276","Connie Norman",21,25,4,3,25,"Did Not Play"
"126.279","Ken Norman",23,32,9,3,24,"18.1"
"126.282","Audie Norris",22,24,2,1,24,"5.1"
"126.285","Moochie Norris",23,32,9,7,28,"Did Not Play (other pro league—CBA)"
"126.289","Sylvester Norris",22,22,0,1,22,"2.4"
"126.292","Willie Norwood",24,30,6,4,25,"8.3"
"126.295","George Nostrand",23,26,3,7,26,"12"
"126.298","Stan Noszka",26,28,2,2,26,"8.7"
"126.301","Mike Novak",33,38,5,5,33,"Did Not Play (other pro league—NPBL)"
"126.304","Steve Novak",23,33,10,10,28,"8.8"
"126.307","Mel Nowell",23,28,5,3,28,"Did Not Play"
"126.310","Dirk Nowitzki",20,39,19,1,27,"26.6"
"126.312","Frank Ntilikina",19,19,0,1,19,"5.9"
"126.314","James Nunnally",23,23,0,3,23,"4.5"
"126.317","Jusuf Nurkic",20,23,3,3,22,"15.2"
"126.319","Dennis Nutt",23,23,0,1,23,"2.3"
"126.322","David Nwaba",24,25,1,2,25,"7.9"
"126.325","Julius Nwosu",23,23,0,1,23,"1.3"
"133.36","Charles O'Bannon",22,23,1,1,23,"3.1"
"133.39","Ed O'Bannon",23,24,1,3,23,"6.2"
"133.42","John O'Boyle",24,24,0,1,24,"4.2"
"133.45","Bob O'Brien",21,22,1,3,21,"2.2"
"133.48","J.J. O'Brien",23,23,0,1,23,"0"
"133.51","Jim O'Brien",22,23,1,2,23,"4.9"
"133.54","Jimmy O'Brien",21,24,3,4,23,"8.6"
"133.57","Ralph O'Brien",23,24,1,4,23,"9"
"133.60","Johnny O'Bryant",21,24,3,4,24,"4.8"
"133.63","Patrick O'Bryant",20,23,3,4,22,"4.7"
"133.66","Dermie O'Connell",20,21,1,3,20,"9.7"
"133.69","Andy O'Donnell",24,24,0,1,24,"3.6"
"133.72","Buddy O'Grady",27,29,2,4,29,"4.8"
"133.75","Fran O'Hanlon",22,22,0,1,22,"1.6"
"133.78","Dick O'Keefe",24,27,3,1,26,"7"
"133.81","Tommy O'Keefe",22,22,0,3,22,"4"
"133.84","Mike O'Koren",22,29,7,2,23,"11.4"
"133.87","Grady O'Malley",21,21,0,1,21,"2.1"
"133.90","Jermaine O'Neal",18,35,17,8,26,"24.3"
"133.92","Shaquille O'Neal",20,38,18,7,27,"29.7"
"133.95","Royce O'Neale",24,24,0,1,24,"5"
"133.98","Mike O'Neill",NA,NA,NA,1,NA,"3"
"133.100","Kyle O'Quinn",22,27,5,2,27,"7.1"
"133.103","Kevin O'Shea",25,27,2,4,26,"8.7"
"133.106","Garland O'Shields",25,25,0,1,25,"0.4"
"133.109","Dan O'Sullivan",22,27,5,8,27,"Did Not Play (other pro league—GBA, USBL)"
"133.112","Charles Oakley",22,40,18,5,26,"14.6"
"133.115","Fabricio Oberto",30,35,5,3,32,"4.8"
"133.117","Daniel Ochefu",23,23,0,1,23,"1.3"
"133.120","Greg Oden",21,26,5,3,22,"Did Not Play"
"133.123","Lamar Odom",20,33,13,4,21,"17.2"
"133.126","Bud Ogden",23,24,1,1,23,"4.1"
"133.129","Ralph Ogden",23,23,0,1,23,"1.3"
"133.132","Alan Ogg",23,25,2,4,25,"2.7"
"133.135","Don Ohl",24,33,9,5,29,"20.6"
"133.138","Tim Ohlbrecht",24,24,0,1,24,"1"
"133.140","Semi Ojeleye",23,23,0,1,23,"2.7"
"133.143","Emeka Okafor",22,35,13,5,22,"Did Not Play"
"133.146","Jahlil Okafor",20,22,2,3,20,"17.5"
"133.149","Mehmet Okur",23,32,9,3,26,"18"
"133.151","Victor Oladipo",21,25,4,3,25,"23.1"
"133.154","Hakeem Olajuwon",22,39,17,2,32,"27.8"
"133.157","Mark Olberding",19,30,11,7,19,"15.3"
"133.160","Jawann Oldham",23,33,10,10,28,"Did Not Play (injury)"
"133.163","John Oldham",26,27,1,1,27,"8.4"
"133.166","Frank Oleynick",20,21,1,1,20,"5.9"
"133.169","John Olive",23,24,1,1,23,"1.3"
"133.172","Brian Oliver",22,29,7,5,22,"Did Not Play (other pro league—Italy)"
"133.175","Dean Oliver",23,24,1,1,23,"2.1"
"133.178","Jimmy Oliver",22,29,7,8,28,"Did Not Play (other pro league—Spain)"
"133.181","Kevin Ollie",25,37,12,13,30,"8"
"133.184","Gene Ollrich",27,27,0,1,27,"3.1"
"133.187","Michael Olowokandi",23,31,8,4,27,"12.3"
"133.190","Bud Olsen",22,29,7,7,24,"7.5"
"133.193","Kelly Olynyk",22,26,4,2,26,"11.5"
"133.196","Arinze Onuaku",26,29,3,6,27,"Did Not Play"
"133.199","Chinanu Onuaku",20,21,1,1,21,"4"
"133.202","Barry Orms",22,23,1,4,23,"9.6"
"133.205","Johnny Orr",22,22,0,3,22,"4"
"133.208","Louis Orr",22,29,7,2,26,"12.7"
"133.211","Jose Ortiz",25,26,1,1,26,"3.2"
"133.214","Daniel Orton",21,23,2,3,23,"3"
"133.217","Chuck Osborne",23,23,0,1,23,"1.3"
"133.220","Cedi Osman",22,22,0,1,22,"3.9"
"133.222","Wally Osterkorn",23,26,3,1,25,"8.8"
"133.225","Greg Ostertag",22,32,10,2,23,"7.3"
"133.228","Matt Othick",23,23,0,1,23,"2"
"133.231","Don Otten",28,31,3,6,28,"14.9"
"133.234","Mac Otten",24,24,0,3,24,"3.3"
"133.237","Kelly Oubre",20,22,2,1,22,"11.8"
"133.240","Bo Outlaw",22,36,14,5,26,"9.5"
"133.244","Travis Outlaw",19,29,10,5,23,"13.3"
"133.246","Claude Overton",25,25,0,1,25,"3.9"
"133.249","Doug Overton",23,34,11,10,23,"Did Not Play (other pro league—CBA)"
"133.252","Andre Owens",25,27,2,3,27,"Did Not Play (other pro league—D-League)"
"133.256","Billy Owens",22,31,9,7,23,"16.5"
"133.259","Chris Owens",23,23,0,1,23,"4"
"133.263","Eddie Owens",24,24,0,1,24,"2.6"
"133.266","Jim Owens",23,24,1,1,23,"3.1"
"133.269","Keith Owens",22,22,0,1,22,"1.3"
"133.272","Larry Owens",28,29,1,4,28,"6.2"
"133.275","Red Owens",24,26,2,6,26,"Did Not Play (other pro league—NPBL)"
"133.278","Tom Owens",22,33,11,12,29,"18.5"
"133.281","Ray Owes",24,24,0,1,24,"3.1"
"133.284","Olumide Oyedeji",19,21,2,2,19,"1.5"
"140.36","Joe Pace",23,24,1,1,24,"3.9"
"140.39","Zaza Pachulia",19,33,14,5,22,"12.2"
"140.41","Robert Pack",22,34,12,8,26,"18.1"
"140.44","Wayne Pack",24,24,0,1,24,"2.9"
"140.47","Gerald Paddio",25,28,3,7,25,"Did Not Play (other pro league—CBA)"
"140.50","Scott Padgett",23,30,7,5,25,"6.7"
"140.53","Dana Pagett",22,22,0,1,22,"1"
"140.56","Marcus Paige",24,24,0,1,24,"2.4"
"140.59","Fred Paine",23,23,0,1,23,"2.3"
"140.62","Milt Palacio",21,27,6,7,27,"6.2"
"140.66","Togo Palazzi",22,27,5,3,24,"10.7"
"140.69","Bud Palmer",25,27,2,1,26,"13"
"140.72","Errol Palmer",NA,NA,NA,1,NA,"7.9"
"140.74","Jim Palmer",25,27,2,3,25,"10.3"
"140.77","Walter Palmer",22,24,2,3,24,"Did Not Play (other pro league—Germany)"
"140.80","Andy Panko",23,23,0,1,23,"0"
"140.83","Georgios Papagiannis",19,20,1,3,19,"5.6"
"140.85","Kostas Papanikolaou",24,25,1,2,24,"4.2"
"140.87","Jannero Pargo",23,35,12,12,24,"Did Not Play (other pro league—Russia, Greece)"
"140.90","Jeremy Pargo",25,26,1,4,26,"7.8"
"140.93","Easy Parham",27,29,2,2,27,"5.7"
"140.96","Robert Parish",23,43,20,4,28,"19.9"
"140.99","Med Park",22,26,4,3,25,"9.7"
"140.102","Anthony Parker",22,36,14,5,32,"Did Not Play (other pro league—Israel)"
"140.105","Jabari Parker",19,22,3,1,21,"20.1"
"140.108","Smush Parker",21,26,5,8,24,"Did Not Play (other pro league—Greece, CBA)"
"140.111","Sonny Parker",21,26,5,1,23,"15.2"
"140.114","Tony Parker",19,35,16,1,26,"22"
"140.116","Barry Parkhill",22,24,2,2,23,"7.8"
"140.119","Jack Parkinson",25,25,0,1,25,"0.8"
"140.122","Charles Parks",NA,NA,NA,1,NA,"0"
"140.124","Cherokee Parks",23,31,8,8,25,"7.1"
"140.127","Richard Parks",24,24,0,1,24,"3.3"
"140.130","Jack Parr",22,22,0,1,22,"4"
"140.133","Doyle Parrack",25,25,0,1,25,"4.7"
"140.136","Charlie Parsley",24,24,0,1,24,"2.4"
"140.139","Chandler Parsons",23,29,6,3,25,"16.6"
"140.142","Zarko Paspalj",23,23,0,1,23,"2.6"
"140.144","Marty Passaglia",27,29,2,3,29,"Did Not Play (other pro league—PBLA)"
"140.147","George Pastushok",24,24,0,1,24,"3.1"
"140.150","Myles Patrick",26,26,0,1,26,"1.7"
"140.153","Stan Patrick",27,27,0,3,27,"6.7"
"140.156","Andrae Patterson",23,24,1,1,23,"3.3"
"140.159","George Patterson",28,28,0,1,28,"2"
"140.162","Lamar Patterson",24,25,1,1,24,"2.4"
"140.165","Patrick Patterson",21,28,7,5,23,"11.6"
"140.168","Ruben Patterson",23,32,9,7,31,"14.7"
"140.171","Steve Patterson",23,27,4,3,25,"7.8"
"140.174","Tom Patterson",24,25,1,2,24,"2.4"
"140.177","Worthy Patterson",26,26,0,1,26,"1.8"
"140.180","Justin Patton",20,20,0,1,20,"2"
"140.183","Brandon Paul",26,26,0,1,26,"2.3"
"140.186","Chris Paul",20,32,12,4,23,"22.8"
"140.189","Charlie Paulk",22,25,3,6,24,"Did Not Play (military service)"
"140.192","Jerry Paulson",22,22,0,1,22,"3.3"
"140.195","Billy Paultz",22,36,14,7,24,"16.7"
"140.199","Sasha Pavlovic",20,29,9,8,23,"9"
"140.201","Jim Paxson",24,25,1,2,25,"9.8"
"140.204","Jim Paxson",22,32,10,3,25,"21.7"
"140.207","John Paxson",23,33,10,2,26,"11.3"
"140.210","Johnny Payak",23,26,3,5,23,"Did Not Play (other pro league—NPBL)"
"140.213","Adreian Payne",23,26,3,4,23,"7.2"
"140.216","Cameron Payne",21,23,2,3,23,"8.8"
"140.219","Kenny Payne",23,26,3,1,26,"6.5"
"140.222","Tom Payne",21,21,0,1,21,"4.1"
"140.225","Elfrid Payton",20,23,3,3,23,"13"
"140.228","Gary Payton",22,38,16,6,31,"24.2"
"140.231","Gary Payton",24,25,1,3,25,"3.5"
"140.234","Mel Payton",25,26,1,2,26,"7.1"
"140.237","George Pearcy",27,27,0,1,27,"2.5"
"140.240","Henry Pearcy",24,24,0,1,24,"2.5"
"140.243","Oleksiy Pecherov",22,24,2,2,24,"4.5"
"140.245","Wiley Peck",22,22,0,1,22,"3.5"
"140.248","Rich Peek",24,24,0,1,24,"4.6"
"140.252","Anthony Peeler",23,35,12,6,27,"14.5"
"140.255","George Peeples",24,29,5,3,27,"11.7"
"140.258","Nikola Pekovic",25,30,5,1,28,"17.5"
"140.260","Jake Pelkington",33,33,0,3,33,"11.8"
"140.263","Sam Pellom",28,31,3,3,29,"5.9"
"140.266","Mike Penberthy",26,27,1,1,26,"5"
"140.269","Jerry Pender",23,23,0,1,23,"2.5"
"140.272","Desmond Penigar",22,22,0,1,22,"3.2"
"140.275","Kirk Penney",23,24,1,2,23,"1.5"
"140.278","Mike Peplowski",23,25,2,5,23,"3.2"
"140.281","Will Perdue",23,35,12,3,31,"8.7"
"140.284","Kendrick Perkins",19,33,14,6,25,"Did Not Play"
"140.286","Sam Perkins",23,39,16,5,30,"16.5"
"140.289","Warren Perkins",27,28,1,1,27,"6.2"
"140.292","Kosta Perovic",22,22,0,1,22,"1.4"
"140.294","London Perrantes",23,23,0,1,23,"0.5"
"140.297","Aulcie Perry",24,24,0,1,24,"8.6"
"140.300","Curtis Perry",22,29,7,5,26,"13.4"
"140.303","Elliot Perry",22,32,10,9,25,"Did Not Play (other pro league—CBA)"
"140.306","Ron Perry",24,26,2,7,25,"19.3"
"140.309","Tim Perry",23,30,7,4,26,"12.3"
"140.312","Chuck Person",22,35,13,6,24,"Did Not Play (injury)"
"140.315","Wesley Person",23,33,10,8,30,"15.1"
"140.318","Alec Peters",22,22,0,1,22,"4.1"
"140.321","Jim Petersen",22,29,7,3,24,"11.3"
"140.324","Loy Petersen",23,24,1,1,24,"3"
"140.327","Bob Peterson",22,24,2,4,24,"5.3"
"140.330","Ed Peterson",25,26,1,3,26,"7.8"
"140.333","Mel Peterson",25,31,6,4,29,"Did Not Play"
"140.336","Morris Peterson",23,33,10,3,28,"16.8"
"140.339","Geoff Petrie",22,27,5,1,24,"24.9"
"140.342","Johan Petro",20,27,7,6,21,"6.2"
"140.344","Drazen Petrovic",25,28,3,3,28,"22.3"
"140.346","Richard Petruska",25,25,0,1,25,"2.4"
"140.350","Bob Pettit",22,32,10,2,29,"31.1"
"140.353","Jerry Pettway",23,24,1,1,23,"9.4"
"140.356","Roger Phegley",22,27,5,6,24,"14.4"
"140.359","Jack Phelan",24,24,0,3,24,"4.1"
"140.362","James Phelan",24,24,0,1,24,"0.8"
"140.365","Derrick Phelps",22,22,0,1,22,"0"
"140.368","Michael Phelps",24,26,2,2,26,"4.5"
"140.371","Andy Phillip",25,35,10,5,26,"12"
"140.374","Eddie Phillips",21,21,0,1,21,"3.2"
"140.377","Gary Phillips",22,26,4,2,24,"10"
"140.380","Gene Phillips",23,24,1,1,23,"2.8"
"140.383","Bobby Phills",22,30,8,2,26,"14.6"
"140.386","Eric Piatkowski",24,37,13,4,27,"11.3"
"140.389","Walter Piatkowski",23,26,3,3,23,"Did Not Play"
"140.392","Paul Pierce",21,39,18,4,28,"26.8"
"140.395","Ricky Pierce",23,38,15,9,30,"23"
"140.398","Stan Pietkiewicz",22,24,2,3,23,"4.6"
"140.401","Mickael Pietrus",21,30,9,6,24,"11.1"
"140.403","John Pilch",26,26,0,1,26,"0.6"
"140.406","Ed Pinckney",22,33,11,8,25,"12.3"
"140.409","Kevinn Pinkney",23,23,0,1,23,"5.2"
"140.412","John Pinone",22,22,0,1,22,"2.9"
"140.415","Dave Piontek",22,28,6,5,24,"10.6"
"140.418","Tom Piotrowski",23,23,0,1,23,"1.7"
"140.421","Scottie Pippen",22,38,16,3,28,"22"
"140.424","Charles Pittman",24,27,3,1,27,"5.1"
"140.427","Dexter Pittman",22,25,3,4,23,"3"
"140.430","Zoran Planinic",21,23,2,1,22,"5"
"140.432","Tibor Pleiss",26,26,0,1,26,"2"
"140.434","Marshall Plumlee",24,25,1,2,24,"1.9"
"140.437","Mason Plumlee",23,27,4,4,26,"11.1"
"140.440","Miles Plumlee",24,29,5,6,25,"8.1"
"140.443","Gary Plummer",22,30,8,7,30,"Did Not Play (other pro league—Spain)"
"140.446","Pavel Podkolzin",20,21,1,1,21,"3"
"140.448","Jakob Poeltl",21,22,1,1,22,"6.9"
"140.451","Dwayne Polee",23,23,0,1,23,"2"
"140.455","Jim Pollard",26,32,6,1,29,"15.5"
"140.458","Scot Pollard",22,32,10,5,25,"6.5"
"140.461","Ralph Polson",23,23,0,3,23,"3.9"
"140.464","Olden Polynice",23,39,16,8,29,"Did Not Play (other pro league—CBA)"
"140.467","Cliff Pondexter",21,23,2,1,21,"5.8"
"140.470","Quincy Pondexter",22,29,7,6,26,"Did Not Play"
"140.473","David Pope",22,23,1,2,22,"1.9"
"140.476","Mark Pope",25,32,7,4,28,"Did Not Play (other pro league—CBA)"
"140.480","Dave Popson",24,27,3,6,24,"Did Not Play (other pro league—CBA)"
"140.483","Ben Poquette",22,31,9,5,27,"11"
"140.486","Chris Porter",22,22,0,1,22,"8.6"
"140.489","Howard Porter",23,29,6,5,28,"13.2"
"140.492","Kevin Porter",22,32,10,7,27,"Did Not Play (injury—leg)"
"140.495","Otto Porter",20,24,4,1,24,"14.7"
"140.498","Terry Porter",22,38,16,4,29,"18.2"
"140.501","Willie Porter",25,26,1,5,25,"13.1"
"140.504","Bobby Portis",20,22,2,1,22,"13.2"
"140.507","Bob Portman",22,25,3,2,23,"7.6"
"140.510","Kristaps Porzingis",20,22,2,1,22,"22.7"
"140.512","James Posey",23,34,11,8,26,"14.1"
"140.515","Lavor Postell",22,24,2,1,23,"4"
"140.518","John Postley",27,27,0,1,27,"2"
"140.521","Vitaly Potapenko",21,31,10,5,23,"10.8"
"140.524","Leon Powe",23,27,4,4,24,"7.9"
"140.527","Cincinnatus Powell",25,32,7,4,27,"20.1"
"140.530","Dwight Powell",23,26,3,3,26,"8.5"
"140.533","Josh Powell",23,31,8,9,25,"Did Not Play"
"140.536","Kasib Powell",26,26,0,1,26,"7.6"
"140.539","Norman Powell",22,24,2,1,23,"8.4"
"140.542","Roger Powell",24,24,0,1,24,"0.7"
"140.545","Alex Poythress",23,24,1,2,23,"10.7"
"140.548","Marlbert Pradd",23,24,1,1,24,"5.2"
"140.551","Mike Pratt",22,23,1,1,22,"5.6"
"140.554","Paul Pressey",24,34,10,3,26,"16.1"
"140.557","Phil Pressey",22,24,2,4,24,"3.9"
"140.560","Dominic Pressley",24,24,0,3,24,"2.1"
"140.563","Harold Pressley",23,26,3,1,25,"12.3"
"140.566","Stephen Previs",22,22,0,1,22,"1.8"
"140.569","A.J. Price",23,28,5,6,28,"10.5"
"140.572","Brent Price",24,33,9,5,27,"Did Not Play (injury)"
"140.576","Jim Price",23,29,6,6,25,"21.2"
"140.579","Mark Price",22,33,11,4,25,"19.6"
"140.582","Mike Price",22,24,2,4,24,"5.1"
"140.585","Ronnie Price",22,33,11,6,32,"5.3"
"140.589","Tony Price",24,24,0,1,24,"0.8"
"140.592","Bob Priddy",22,22,0,1,22,"2.3"
"140.595","Pablo Prigioni",35,38,3,4,37,"4.7"
"140.597","Tayshaun Prince",22,35,13,5,24,"14.7"
"140.600","John Pritchard",23,23,0,1,23,"3.1"
"140.603","Kevin Pritchard",23,28,5,8,24,"Did Not Play (other pro league—Spain)"
"140.606","Laron Profit",22,28,6,4,23,"Did Not Play (other pro league—Italy)"
"140.609","Gabe Pruitt",21,22,1,1,21,"2.1"
"140.612","Joel Przybilla",21,33,12,5,25,"6.4"
"140.615","Les Pugh",26,27,1,2,26,"7.7"
"140.618","Roy Pugh",26,26,0,4,26,"2.3"
"140.621","Anthony Pullard",26,26,0,1,26,"2.1"
"140.624","Jacob Pullen",28,28,0,1,28,"0.7"
"140.627","Rodney Purvis",23,23,0,1,23,"6"
"140.630","Don Putman",24,27,3,1,24,"6.6"
"147.36","Zhou Qi",22,22,0,1,22,"1.2"
"147.38","Tim Quarterman",22,23,1,2,22,"1.9"
"147.41","Bob Quick",22,25,3,4,24,"8"
"147.44","Chris Quinn",23,29,6,5,24,"Did Not Play (other pro league—Russia)"
"147.47","Brian Quinnett",23,25,2,3,24,"4.7"
"153.36","Ivan Rabb",20,20,0,1,20,"5.6"
"153.39","Luther Rackley",23,27,4,6,23,"7.6"
"153.42","Howie Rader",27,27,0,1,27,"1.3"
"153.45","Mark Radford",22,23,1,1,23,"3.7"
"153.48","Wayne Radford",22,22,0,1,22,"3.9"
"153.51","Dino Radja",26,29,3,1,28,"19.7"
"153.53","Vladimir Radmanovic",21,32,11,8,23,"12"
"153.55","Aleksandar Radojevic",23,28,5,6,23,"Did Not Play (other pro league—Slovenia, Italy)"
"153.58","Frank Radovich",23,23,0,1,23,"2.4"
"153.61","Moe Radovich",23,23,0,1,23,"3.5"
"153.64","Miroslav Raduljica",26,27,1,2,26,"3.8"
"153.66","Ray Radziszewski",22,22,0,1,22,"0"
"153.69","Ray Ragelis",23,23,0,1,23,"1.3"
"153.72","Sherwin Raiken",24,24,0,1,24,"1.5"
"153.75","Ed Rains",25,26,1,1,25,"3.9"
"153.78","Igor Rakocevic",24,24,0,1,24,"1.9"
"153.80","Kurt Rambis",23,36,13,5,30,"11.1"
"153.83","Peter John Ramos",19,19,0,1,19,"1.8"
"153.85","Cal Ramsey",22,23,1,4,22,"11.4"
"153.88","Frank Ramsey",23,32,9,2,26,"Did Not Play (military service—U.S. Army)"
"153.91","Ray Ramsey",27,27,0,1,27,"1"
"153.94","Mark Randall",24,27,3,5,24,"3.7"
"153.97","Chasson Randle",23,23,0,3,23,"5.3"
"153.100","Julius Randle",20,23,3,1,23,"16.1"
"153.103","Anthony Randolph",19,24,5,5,21,"11.7"
"153.106","Shavlik Randolph",22,31,9,8,23,"Did Not Play (other pro league—Puerto Rico)"
"153.109","Zach Randolph",20,36,16,6,25,"23.6"
"153.112","Wally Rank",22,22,0,1,22,"2.2"
"153.115","Kelvin Ransey",22,27,5,3,23,"16.1"
"153.118","Sam Ranzino",23,23,0,1,23,"2.2"
"153.121","Bobby Rascoe",27,29,2,1,27,"8.8"
"153.124","Blair Rasmussen",23,30,7,2,25,"12.7"
"153.127","Xavier Rathan-Mayes",23,23,0,1,23,"5.8"
"153.130","George Ratkovicz",27,32,5,4,28,"12.9"
"153.132","Ed Ratleff",23,27,4,1,24,"11.8"
"153.135","Mike Ratliff",21,22,1,1,21,"4.2"
"153.138","Theo Ratliff",22,37,15,10,27,"12.4"
"153.141","Andy Rautins",24,24,0,1,24,"1.6"
"153.144","Leo Rautins",23,24,1,2,23,"1.7"
"153.148","Allan Ray",22,22,0,1,22,"6.2"
"153.151","Clifford Ray",23,32,9,2,26,"9.4"
"153.154","Don Ray",28,28,0,1,28,"6"
"153.157","James Ray",23,25,2,1,25,"3.8"
"153.160","Jim Ray",23,26,3,2,23,"Did Not Play"
"153.163","Jimmy Rayl",26,27,1,1,26,"12"
"153.166","Craig Raymond",23,27,4,8,24,"15.4"
"153.169","Connie Rea",19,19,0,1,19,"1.2"
"153.172","Joe Reaves",23,23,0,3,23,"5.3"
"153.175","Zeljko Rebraca",29,33,4,4,31,"8.3"
"153.177","Eldridge Recasner",27,34,7,6,30,"9.3"
"153.180","Michael Redd",21,32,11,2,27,"26.7"
"153.183","Frank Reddout",NA,NA,NA,1,NA,"1.9"
"153.185","J.J. Redick",22,33,11,5,33,"17.1"
"153.188","Marlon Redmond",23,24,1,3,23,"7.2"
"153.191","Davon Reed",22,22,0,1,22,"3"
"153.194","Hub Reed",22,28,6,5,23,"9.7"
"153.197","Justin Reed",23,25,2,3,24,"6.3"
"153.200","Ron Reed",23,24,1,1,24,"8.5"
"153.203","Willie Reed",25,27,2,5,26,"5.3"
"153.206","Willis Reed",22,31,9,1,27,"21.7"
"153.209","Bryant Reeves",22,27,5,1,24,"16.3"
"153.212","Khalid Reeves",22,27,5,7,22,"9.2"
"153.215","Richie Regan",25,27,2,2,26,"9.8"
"153.218","Don Rehfeldt",24,25,1,3,24,"7.3"
"153.221","Billy Reid",23,23,0,1,23,"3.2"
"153.225","Don Reid",22,29,7,4,26,"6.4"
"153.228","J.R. Reid",21,32,11,8,30,"Did Not Play (other pro league—France)"
"153.231","Jim Reid",22,22,0,1,22,"3.5"
"153.234","Robert Reid",22,35,13,6,25,"Did Not Play (retired)"
"153.237","Ryan Reid",25,25,0,1,25,"1.6"
"153.240","Jared Reiner",22,24,2,3,24,"Did Not Play (injury—knee)"
"153.243","Chick Reiser",33,35,2,2,33,"11.5"
"153.246","Richard Rellford",23,23,0,1,23,"4"
"153.249","Terrence Rencher",22,22,0,3,22,"3"
"153.252","John Rennicke",22,22,0,1,22,"1.8"
"153.255","Bob Rensberger",25,25,0,1,25,"0"
"153.258","Efthimi Rentzias",27,27,0,1,27,"1.5"
"153.260","Shawn Respert",23,26,3,5,25,"8.2"
"153.263","Kevin Restani",23,30,7,5,28,"10.7"
"153.266","George Reynolds",22,22,0,1,22,"2.1"
"153.269","Jerry Reynolds",23,33,10,6,28,"Did Not Play (other pro league—USBL)"
"153.272","Kendall Rhine",24,25,1,2,25,"9"
"153.275","Gene Rhodes",25,25,0,1,25,"5.2"
"153.278","Rodrick Rhodes",24,26,2,4,24,"5.8"
"153.282","Glen Rice",22,36,14,6,29,"26.8"
"153.285","Glen Rice",23,24,1,1,23,"2.9"
"153.288","Chris Richard",23,25,2,3,25,"Did Not Play (other pro league—D-League)"
"153.291","Clint Richardson",23,30,7,2,29,"9.7"
"153.294","Jason Richardson",21,34,13,7,25,"Did Not Play (Injury—knee)"
"153.297","Jeremy Richardson",22,24,2,6,24,"3.1"
"153.300","Josh Richardson",22,24,2,1,24,"12.9"
"153.303","Malachi Richardson",21,22,1,3,21,"3.6"
"153.306","Micheal Ray Richardson",23,30,7,4,29,"20.1"
"153.309","Norm Richardson",22,22,0,3,22,"3.8"
"153.312","Pooh Richardson",23,32,9,3,24,"17.1"
"153.315","Quentin Richardson",20,32,12,5,23,"17.2"
"153.318","Mitch Richmond",23,36,13,4,31,"25.9"
"153.321","John Richter",22,22,0,1,22,"4.3"
"153.324","Dick Ricketts",22,24,2,4,23,"11.2"
"153.327","Isaiah Rider",22,30,8,5,23,"20.4"
"153.330","Jackie Ridgle",23,23,0,1,23,"1.8"
"153.333","Luke Ridnour",22,33,11,6,30,"12.1"
"153.336","Mel Riebe",30,32,2,4,30,"12.1"
"153.339","Bob Riedy",22,22,0,1,22,"5.7"
"153.342","Jim Riffey",27,27,0,1,27,"4.3"
"153.345","Antoine Rigaudeau",31,31,0,1,31,"1.5"
"153.347","Tom Riker",22,24,2,1,24,"3"
"153.350","Bob Riley",22,22,0,1,22,"1.9"
"153.353","Eric Riley",23,28,5,6,24,"Did Not Play (other pro league—Greece)"
"153.356","Pat Riley",22,30,8,4,29,"11"
"153.359","Ron Riley",22,25,3,3,22,"8.4"
"153.362","Rich Rinaldi",22,24,2,4,23,"8.5"
"153.365","Mike Riordan",23,31,8,5,27,"18.1"
"153.368","Arnie Risen",24,33,9,2,24,"16.6"
"153.371","Tex Ritter",24,26,2,1,24,"6.1"
"153.374","Ramon Rivas",22,22,0,1,22,"1.4"
"153.377","Austin Rivers",20,25,5,4,25,"15.1"
"153.380","David Rivers",24,27,3,3,25,"Did Not Play (other pro league—CBA)"
"153.383","Doc Rivers",22,34,12,5,29,"15.2"
"153.386","Lee Robbins",25,26,1,1,25,"6.3"
"153.389","Red Robbins",23,30,7,6,25,"16.4"
"153.392","Andre Roberson",22,26,4,1,25,"6.6"
"153.395","Anthony Roberson",22,25,3,6,23,"Did Not Play (other pro league—Israel, Turkey)"
"153.398","Rick Roberson",22,28,6,5,26,"13.5"
"153.401","Terrance Roberson",24,24,0,1,24,"0"
"153.404","Anthony Roberts",22,28,6,3,22,"Did Not Play (other pro league—CBA)"
"153.407","Bill Roberts",23,24,1,4,23,"6.3"
"153.410","Brian Roberts",27,31,4,5,28,"9.4"
"153.413","Fred Roberts",23,36,13,9,30,"Did Not Play (other pro league—Spain)"
"153.416","Joe Roberts",24,31,7,3,25,"Did Not Play"
"153.419","Lawrence Roberts",23,24,1,1,24,"5.2"
"153.423","Marv Roberts",22,27,5,6,23,"12.3"
"153.426","Stanley Roberts",21,29,8,6,22,"Did Not Play (injury—achilles)"
"153.429","Alvin Robertson",22,33,11,6,25,"Did Not Play (injury—back)"
"153.432","Oscar Robertson",22,35,13,2,25,"31.4"
"153.435","Ryan Robertson",23,23,0,1,23,"5"
"153.438","Tony Robertson",22,23,1,2,22,"5.9"
"153.441","Rick Robey",23,30,7,4,23,"12.4"
"153.444","Bernard Robinson",24,26,2,3,25,"6.4"
"153.447","Chris Robinson",22,23,1,3,23,"5.7"
"153.450","Cliff Robinson",19,31,12,9,21,"Did Not Play (other pro league—Italy)"
"153.453","Clifford Robinson",23,40,17,6,28,"21.3"
"153.456","David Robinson",24,37,13,1,28,"29.8"
"153.459","Devin Robinson",22,22,0,1,22,"2"
"153.462","Eddie Robinson",23,27,4,2,25,"9"
"153.465","Flynn Robinson",25,32,7,7,28,"21.8"
"153.468","Glenn Robinson",22,32,10,4,25,"23.4"
"153.471","Glenn Robinson",21,24,3,4,23,"6.1"
"153.474","Jackie Robinson",23,26,3,4,24,"Did Not Play"
"153.477","Jamal Robinson",27,27,0,1,27,"1"
"153.480","James Robinson",23,30,7,6,24,"Did Not Play (other pro league—Greece)"
"153.483","Larry Robinson",23,34,11,12,23,"Did Not Play (other pro league—Spain)"
"153.486","Nate Robinson",21,31,10,9,24,"17.2"
"153.489","Oliver Robinson",22,22,0,1,22,"2.9"
"153.492","Ronnie Robinson",22,23,1,4,22,"7.2"
"153.495","Rumeal Robinson",24,30,6,8,25,"Did Not Play (other pro league—Spain)"
"153.498","Samuel Robinson",23,24,1,1,23,"11"
"153.501","Thomas Robinson",21,25,4,7,23,"8.8"
"153.504","Truck Robinson",23,33,10,6,27,"24.2"
"153.507","Wayne Robinson",22,22,0,1,22,"7.9"
"153.510","Wilbert Robinson",24,24,0,1,24,"8.6"
"153.513","Bill Robinzine",23,29,6,5,28,"13.9"
"153.516","Dave Robisch",22,34,12,11,26,"16.5"
"153.519","Red Rocha",24,33,9,5,27,"Did Not Play (retired)"
"153.522","John Roche",22,32,10,8,26,"Did Not Play (other pro league—Italy)"
"153.525","Gene Rock",26,26,0,1,26,"0.9"
"153.528","Jack Rocker",25,25,0,1,25,"1.9"
"153.531","Guy Rodgers",23,34,11,6,30,"18.6"
"153.534","Dennis Rodman",25,38,13,5,26,"11.6"
"153.537","Sergio Rodriguez",20,30,10,6,30,"Did Not Play"
"153.539","Lou Roe",23,24,1,2,24,"2.4"
"153.542","Carlos Rogers",23,30,7,6,25,"9.8"
"153.546","Harry Rogers",25,25,0,1,25,"7.6"
"153.549","Johnny Rogers",23,24,1,2,23,"4.2"
"153.553","Marshall Rogers",23,23,0,1,23,"3.8"
"153.556","Rodney Rogers",22,33,11,8,26,"15.1"
"153.559","Roy Rogers",23,26,3,6,23,"Did Not Play (other pro league—Italy)"
"153.562","Willie Rogers",23,23,0,1,23,"2.1"
"153.565","Al Roges",23,24,1,3,23,NA
"153.568","Ken Rohloff",24,24,0,1,24,"0"
"153.571","Kenny Rollins",25,29,4,4,25,"Did Not Play (other pro league—NPBL)"
"153.574","Phil Rollins",25,27,2,5,25,"6.8"
"153.577","Tree Rollins",22,39,17,5,24,"8.9"
"153.580","Lorenzo Romar",22,26,4,4,24,"7.6"
"153.583","Rajon Rondo",20,31,11,6,23,"13.7"
"153.586","Jerry Rook",26,26,0,1,26,"3"
"153.589","Sean Rooks",23,34,11,8,23,"13.5"
"153.592","Derrick Rose",20,29,9,6,22,"Did Not Play (injury—ACL)"
"153.595","Jalen Rose",22,34,12,7,29,"23.8"
"153.598","Malik Rose",22,34,12,5,28,"10.4"
"153.601","Rob Rose",24,24,0,1,24,"0"
"153.604","Petey Rosenberg",28,28,0,1,28,"2.9"
"153.607","Lennie Rosenbluth",25,26,1,1,25,"4.4"
"153.610","Hank Rosenstein",26,26,0,3,26,"8.6"
"153.613","Dick Rosenthal",25,27,2,2,25,"Did Not Play (military service)"
"153.616","Quinton Ross",23,29,6,6,25,"5.2"
"153.619","Terrence Ross",21,26,5,3,25,"12.5"
"153.622","Doug Roth",22,22,0,1,22,"1.9"
"153.625","Scott Roth",24,26,2,4,26,"6.8"
"153.628","Irv Rothenberg",25,27,2,6,26,"7.8"
"153.631","Mickey Rottner",27,28,1,1,27,"7.6"
"153.634","Dan Roundfield",22,33,11,5,29,"19"
"153.637","Giff Roux",23,25,2,3,23,"5.9"
"153.640","Ron Rowan",24,24,0,1,24,"1.7"
"153.644","Curtis Rowe",22,29,7,2,23,"16.1"
"153.647","Jim Rowinski",28,29,1,4,29,"3.6"
"153.650","Derrick Rowland",26,26,0,1,26,"1.5"
"153.653","Brian Rowsom",22,24,2,2,23,"6.6"
"153.656","Brandon Roy",22,28,6,3,24,"Did Not Play (retired)"
"153.659","Donald Royal",23,31,8,7,30,"Did Not Play (other pro league—Israel)"
"153.662","Reggie Royals",24,24,0,1,24,"2"
"153.665","Bob Royer",22,22,0,1,22,"4.7"
"153.668","Clifford Rozier",22,25,3,4,22,"6.8"
"153.672","Terry Rozier",21,23,2,1,23,"11.3"
"153.675","Ricky Rubio",21,27,6,2,27,"13.1"
"153.677","Guy Rucker",25,25,0,1,25,"0"
"153.680","Delaney Rudd",27,30,3,2,28,"4"
"153.683","John Rudd",23,23,0,1,23,"3.2"
"153.686","Damjan Rudez",28,30,2,3,28,"4.8"
"153.688","John Rudometkin",22,24,2,3,23,"7.6"
"153.691","Michael Ruffin",23,32,9,7,24,"Did Not Play (other pro league—Spain)"
"153.694","Trevor Ruffin",24,25,1,2,25,"12.8"
"153.697","Paul Ruffner",22,27,5,5,23,"Did Not Play"
"153.700","Joe Ruklick",21,23,2,1,21,"5"
"153.703","Jeff Ruland",23,34,11,4,25,"Did Not Play (retired)"
"153.706","Bob Rule",23,30,7,5,26,"29.8"
"153.709","Jerry Rullo",23,26,3,2,25,"3.5"
"153.712","Stefano Rusconi",27,27,0,1,27,"1.1"
"153.714","Brandon Rush",23,31,8,4,26,"9.8"
"153.717","Kareem Rush",22,29,7,7,24,"Did Not Play (other pro league—Lithuania)"
"153.720","Bill Russell",22,34,12,1,27,"18.9"
"153.723","Bryon Russell",23,35,12,4,29,"14.1"
"153.726","Campy Russell",23,33,10,3,27,"Did Not Play (injury—knee)"
"153.729","Cazzie Russell",22,33,11,4,27,"21.4"
"153.732","D'Angelo Russell",19,21,2,2,20,"15.6"
"153.735","Frank Russell",23,23,0,1,23,"3.2"
"153.738","Pierre Russell",22,23,1,1,23,"4.9"
"153.741","Rubin Russell",23,23,0,3,23,"7.6"
"153.744","Walker Russell",22,27,5,3,24,"4"
"153.748","Walker Russell",29,29,0,1,29,"3"
"160.36","Arvydas Sabonis",31,38,7,2,33,"Did Not Play (retired)"
"160.38","Domantas Sabonis",20,21,1,2,21,"11.6"
"160.41","Robert Sacre",23,26,3,1,24,"5.4"
"160.44","Ed Sadowski",29,32,3,6,30,"19.4"
"160.47","Kenny Sailors",26,30,4,8,29,"17.3"
"160.50","John Salley",22,35,13,8,27,"Did Not Play (retired)"
"160.53","John Salmons",23,35,12,7,30,"19.9"
"160.56","Al Salvadori",22,22,0,1,22,"3.2"
"160.59","Kevin Salvadori",26,27,1,1,26,"1.6"
"160.62","Soumaila Samake",22,24,2,3,24,"Did Not Play (other pro league—Italy)"
"160.64","Cheikh Samb",23,24,1,5,23,"1.8"
"160.66","JaKarr Sampson",21,24,3,5,21,"Did Not Play"
"160.69","Jamal Sampson",19,23,4,5,21,"3.4"
"160.72","Ralph Sampson",23,31,8,5,24,"22.1"
"160.75","Samardo Samuels",22,24,2,1,22,"7.8"
"160.78","Pepe Sanchez",23,25,2,5,23,"Did Not Play (other pro league—Greece)"
"160.81","Al Sanders",23,23,0,1,23,"2"
"160.84","Frankie Sanders",22,24,2,5,22,"Did Not Play"
"160.87","Jeff Sanders",24,27,3,3,25,"4.3"
"160.90","Larry Sanders",22,28,6,3,24,"Did Not Play"
"160.93","Melvin Sanders",25,25,0,1,25,"2.6"
"160.97","Mike Sanders",22,32,10,5,25,"11"
"160.100","Tom Sanders",22,34,12,1,27,"12.6"
"160.103","Ron Sanford",25,25,0,1,25,"0"
"160.106","Daniel Santiago",24,28,4,3,27,"Did Not Play (other pro league—Italy)"
"160.110","Bob Santini",20,20,0,1,20,"2.8"
"160.113","Wayne Sappleton",24,24,0,1,24,"2.9"
"160.116","Dario Saric",22,23,1,1,23,"14.6"
"160.118","Jason Sasser",23,25,2,5,23,"Did Not Play (other pro league—CBA)"
"160.121","Jeryl Sasser",22,23,1,1,23,"2.6"
"160.124","Tomas Satoransky",25,26,1,1,26,"7.2"
"160.126","Kenny Satterfield",20,21,1,3,21,"5.6"
"160.129","Pep Saul",25,30,5,5,27,"8.6"
"160.132","Woody Sauldsberry",23,31,8,7,24,"Did Not Play (retired)"
"160.135","Glynn Saulters",23,23,0,1,23,"2.7"
"160.138","Fred Saunders",23,26,3,4,23,"6.1"
"160.141","Don Savage",23,28,5,4,28,"Did Not Play (other pro league—ABL)"
"160.144","Predrag Savovic",26,26,0,1,26,"3.1"
"160.148","Alan Sawyer",23,23,0,1,23,"6.6"
"160.151","Brian Scalabrine",23,33,10,3,26,"6.3"
"160.154","Alex Scales",27,27,0,1,27,"0"
"160.157","DeWayne Scales",22,25,3,3,22,"Did Not Play (other pro league—CBA)"
"160.160","Frank Schade",23,23,0,1,23,"1.1"
"160.163","Ben Schadler",23,23,0,1,23,"1.5"
"160.166","Herm Schaefer",30,31,1,1,30,"10.4"
"160.169","Billy Schaeffer",22,24,2,3,24,"6.6"
"160.172","Bob Schafer",NA,NA,NA,4,NA,"4.6"
"160.174","Ben Scharnus",29,31,2,3,29,"Did Not Play (other pro league—ABL)"
"160.177","Marv Schatzman",22,22,0,1,22,"3.4"
"160.180","Fred Schaus",24,28,4,3,25,"15.1"
"160.183","Danny Schayes",22,39,17,8,28,"13.9"
"160.186","Dolph Schayes",21,35,14,2,29,"24.9"
"160.189","Ossie Schectman",27,27,0,1,27,"8.1"
"160.192","Steve Scheffler",23,29,6,5,24,"2.3"
"160.195","Tom Scheffler",30,30,0,1,30,"1.3"
"160.198","Dave Schellhase",22,23,1,1,22,"3"
"160.201","Luke Schenscher",23,24,1,2,23,"1.8"
"160.204","Herb Scherer",22,23,1,2,23,"3.9"
"160.207","Dwayne Schintzius",22,30,8,7,22,"Did Not Play (injury)"
"160.210","Dale Schlueter",23,32,9,6,26,"11.7"
"160.213","Otto Schnellbacher",25,25,0,3,25,"8.7"
"160.216","Dick Schnittker",22,29,7,3,27,"Did Not Play (military service—U.S. Army)"
"160.219","Russ Schoene",22,28,6,6,22,"Did Not Play (other pro league—Italy)"
"160.222","Dave Scholz",21,21,0,1,21,"2"
"160.225","Milt Schoon",24,27,3,3,27,"Did Not Play (other pro league—NBL)"
"160.228","Detlef Schrempf",23,38,15,5,32,"19.2"
"160.231","Dennis Schroder",20,24,4,1,24,"19.4"
"160.233","Howie Schultz",27,30,3,5,27,"Did Not Play (other pro league—NPBL)"
"160.236","Dick Schulz",30,33,3,7,31,"8"
"160.239","Roger Schurig",25,25,0,1,25,"4.8"
"160.242","John Schweitz",24,26,2,3,24,"Did Not Play (other pro league—CBA)"
"160.245","Luis Scola",27,36,9,5,30,"18.3"
"160.247","Fred Scolari",24,32,8,6,28,"14.7"
"160.250","Alvin Scott",22,29,7,1,23,"6.7"
"160.253","Brent Scott",25,25,0,1,25,"1.2"
"160.256","Byron Scott",22,35,13,3,26,"21.7"
"160.259","Charlie Scott",22,31,9,6,23,"34.6"
"160.262","Dennis Scott",22,31,9,7,23,"19.9"
"160.265","James Scott",24,24,0,1,24,"0.1"
"160.268","Mike Scott",24,29,5,2,25,"9.6"
"160.271","Ray Scott",23,33,10,4,28,"19"
"160.274","Shawnelle Scott",24,29,5,4,29,"Did Not Play (other pro league—CBA)"
"160.277","Willie Scott",22,22,0,1,22,"1.6"
"160.280","Paul Scranton",23,23,0,1,23,"1.8"
"160.283","Carey Scurry",23,25,2,3,24,"5"
"160.286","Bruce Seals",20,24,4,2,22,"11.8"
"160.289","Shea Seals",22,22,0,1,22,"1"
"160.292","Malik Sealy",22,29,7,4,26,"13.5"
"160.295","Ed Searcy",23,23,0,1,23,"1.5"
"160.298","Kenny Sears",22,30,8,4,25,"Did Not Play (other pro league—ABL)"
"160.301","Wayne See",26,26,0,1,26,"5.2"
"160.304","Thabo Sefolosha",22,33,11,5,24,"8.5"
"160.306","Rony Seikaly",23,33,10,5,31,"17.3"
"160.309","Glen Selbo",23,23,0,1,23,"3.2"
"160.312","Josh Selby",20,21,1,1,20,"2.3"
"160.315","Wayne Selden",22,23,1,3,23,"9.3"
"160.318","Brad Sellers",24,30,6,6,25,"Did Not Play (other pro league—Greece)"
"160.322","Phil Sellers",23,23,0,1,23,"4.5"
"160.325","Rollie Seltz",26,26,0,1,26,"7.8"
"160.328","Lester Selvage",24,26,2,3,24,"Did Not Play"
"160.331","Frank Selvy",22,31,9,9,22,"Did Not Play (military service—U.S. Army)"
"160.334","Jim Seminoff",24,27,3,2,26,"7.9"
"160.337","Mouhamed Sene",20,22,2,4,22,"3.4"
"160.339","George Senesky",24,31,7,1,28,"10.4"
"160.342","Kevin Seraphin",21,27,6,3,23,"9.1"
"160.344","Ansu Sesay",25,28,3,2,25,"6.4"
"160.347","Ramon Sessions",21,31,10,10,27,"15.8"
"160.350","Ha Seung-Jin",19,20,1,1,20,"1.6"
"160.352","Tom Sewell",22,22,0,1,22,"1"
"160.355","Paul Seymour",20,32,12,3,27,"Did Not Play (other pro league—NBL)"
"160.358","Nick Shaback",28,28,0,1,28,"4.6"
"160.360","Lynn Shackelford",22,22,0,1,22,"2.6"
"160.363","Charles Shackleford",22,32,10,7,23,"Did Not Play (other pro league—Turkey)"
"160.366","Carl Shaeffer",25,26,1,1,25,"3.5"
"160.369","Lee Shaffer",22,24,2,2,23,"18.6"
"160.372","Mustafa Shakur",26,29,3,3,26,"Did Not Play"
"160.375","God Shammgod",21,21,0,1,21,"3.1"
"160.378","Earl Shannon",25,27,2,3,25,"12.1"
"160.381","Howie Shannon",25,26,1,2,25,"13.4"
"160.384","Chuck Share",24,32,8,5,28,NA
"160.387","Bill Sharman",24,34,10,2,31,"22.3"
"160.390","Walter Sharpe",22,22,0,1,22,"1"
"160.394","John Shasky",24,26,2,3,24,"5.5"
"160.397","Ron Shavlik",23,24,1,1,23,"1.4"
"160.400","Brian Shaw",22,36,14,9,24,"Did Not Play (other pro league—Italy)"
"160.404","Casey Shaw",23,23,0,1,23,"0.2"
"160.407","Bob Shea",22,22,0,1,22,"2.2"
"160.410","Fred Sheffield",23,23,0,1,23,"3.4"
"160.413","Craig Shelton",23,24,1,1,23,"4.3"
"160.416","Lonnie Shelton",21,30,9,3,22,"14.9"
"160.419","Tornike Shengelia",21,22,1,3,21,"1.6"
"160.421","Billy Shepherd",23,25,2,3,25,"6.3"
"160.424","Jeffrey Sheppard",24,24,0,1,24,"2.2"
"160.427","Steve Sheppard",23,24,1,3,23,"4.3"
"160.430","Ed Sherod",23,23,0,1,23,"6.2"
"160.433","Charley Shipp",36,36,0,1,36,"4.7"
"160.436","Paul Shirley",25,27,2,3,26,"3"
"160.439","Gene Short",22,22,0,3,22,"2.6"
"160.442","Purvis Short",21,32,11,3,27,"28"
"160.445","Dexter Shouse",26,26,0,1,26,"0"
"160.448","Dick Shrider",25,25,0,1,25,"0.3"
"160.451","Gene Shue",23,32,9,6,28,"22.8"
"160.454","John Shumate",23,28,5,8,25,"Did Not Play (injury)"
"160.457","Iman Shumpert",21,27,6,3,21,"9.5"
"160.460","Alexey Shved",24,26,2,5,26,"14.8"
"160.462","Pascal Siakam",22,23,1,1,23,"7.3"
"160.465","Sam Sibert",23,23,0,1,23,"2.4"
"160.468","Mark Sibley",23,23,0,1,23,"1.6"
"160.471","Jerry Sichting",24,33,9,6,27,"11.5"
"160.474","Donald Sidle",22,25,3,5,23,"20.8"
"160.477","Larry Siegfried",24,32,8,5,29,"14.2"
"160.480","Ralph Siewert",23,23,0,3,23,"1.1"
"160.483","Jack Sikma",22,35,13,2,26,"19.6"
"160.486","James Silas",23,32,9,4,26,"23.8"
"160.489","Paul Silas",21,36,15,6,28,"17.5"
"160.492","Xavier Silas",24,30,6,3,24,"Did Not Play"
"160.496","Garret Siler",24,24,0,1,24,"2.1"
"160.499","Mike Silliman",26,26,0,1,26,"2.5"
"160.502","Wayne Simien",22,23,1,1,22,"3.4"
"160.505","Ben Simmons",21,21,0,1,21,"15.8"
"160.508","Bobby Simmons",21,31,10,6,24,"Did Not Play (injury—ankle)"
"160.511","Cedric Simmons",21,23,2,5,21,"2.9"
"160.514","Connie Simmons",21,30,9,6,23,NA
"160.516","Grant Simmons",24,25,1,1,24,"10.2"
"160.519","Johnny Simmons",22,22,0,1,22,"5.3"
"160.522","Jonathon Simmons",26,28,2,2,28,"13.9"
"160.525","Kobi Simmons",20,20,0,1,20,"6.1"
"160.528","Lionel Simmons",22,28,6,1,22,"18"
"160.531","Miles Simon",23,23,0,1,23,"0.4"
"160.534","Walter Simon",28,34,6,3,29,"21.1"
"160.537","Dickey Simpkins",22,29,7,5,26,"Did Not Play (other pro league—Greece)"
"160.540","Ralph Simpson",21,30,9,7,22,"27.4"
"160.543","Alvin Sims",24,24,0,1,24,"2.8"
"160.546","Bob Sims",23,29,6,5,23,"Did Not Play"
"160.549","Courtney Sims",24,25,1,4,25,"6"
"160.552","Doug Sims",25,25,0,1,25,"1"
"160.555","Henry Sims",22,25,3,5,23,"11.8"
"160.558","Scott Sims",22,22,0,1,22,"2.5"
"160.561","Kyle Singler",24,29,5,3,25,"9.6"
"160.564","Sean Singletary",23,23,0,3,23,"2.6"
"160.567","Chris Singleton",22,24,2,1,22,"4.6"
"160.570","James Singleton",24,30,6,6,30,"Did Not Play (other pro league—Spain)"
"160.573","McKinley Singleton",25,25,0,1,25,"2"
"160.576","Zeke Sinicola",23,25,2,2,25,"Did Not Play (military service)"
"160.579","Charlie Sitton",22,22,0,1,22,"2.1"
"160.582","Peyton Siva",23,23,0,1,23,"2.3"
"160.585","Scott Skiles",22,31,9,5,26,"17.2"
"160.588","Al Skinner",22,27,5,6,25,"15.1"
"160.591","Brian Skinner",22,35,13,9,27,"10.5"
"160.594","Tal Skinner",22,23,1,1,22,"4.8"
"160.597","Whitey Skoog",25,30,5,1,29,"11.6"
"160.600","Jeff Slade",21,21,0,1,21,"1.3"
"160.603","Reggie Slater",24,32,8,9,27,"Did Not Play (other pro league—Italy)"
"160.606","Jim Slaughter",23,23,0,1,23,"5.3"
"160.609","Jose Slaughter",22,22,0,1,22,"3.6"
"160.612","Tamar Slay",22,24,2,2,24,"3.5"
"160.615","Donald Sloan",24,28,4,6,27,"7.4"
"160.618","Jerry Sloan",23,33,10,2,28,"18.3"
"160.621","Uros Slokar",23,23,0,1,23,"1.9"
"160.623","Tom Sluby",22,22,0,1,22,"2.4"
"160.626","Keith Smart",24,24,0,1,24,"1"
"160.629","Marcus Smart",20,23,3,1,22,"10.6"
"160.632","Belus Smawley",28,33,5,4,30,"15.5"
"160.635","Jack Smiley",26,27,1,4,26,"6.7"
"160.638","Adrian Smith",25,35,10,4,29,"18.4"
"160.641","Al Smith",25,29,4,2,26,"11.1"
"160.644","Bill Smith",22,22,0,1,22,"2.6"
"160.647","Bingo Smith",23,33,10,4,28,"15.9"
"160.650","Bobby Smith",22,24,2,3,22,"Did Not Play"
"160.653","Charles Smith",23,31,8,4,24,"21.1"
"160.656","Charles Smith",22,28,6,4,22,"Did Not Play (other pro league—CBA, USBL)"
"160.659","Charles Smith",22,30,8,9,26,"Did Not Play (other pro league—Italy)"
"160.662","Chris Smith",22,24,2,1,23,"5.9"
"160.665","Chris Smith",26,26,0,1,26,"0"
"160.669","Clinton Smith",23,27,4,4,23,"Did Not Play (other pro league—CBA)"
"160.673","Craig Smith",23,28,5,3,25,"10.1"
"160.676","Deb Smith",27,27,0,1,27,"1.5"
"160.679","Dennis Smith",20,20,0,1,20,"15.2"
"160.682","Derek Smith",21,29,8,7,24,"23.5"
"160.685","Don Smith",28,28,0,1,28,"0.8"
"160.688","Don Smith",23,23,0,1,23,"5.2"
"160.691","Donta Smith",21,22,1,1,21,"3.3"
"160.694","Doug Smith",22,26,4,2,23,"10.4"
"160.697","Ed Smith",24,24,0,1,24,"2.9"
"160.700","Elmore Smith",22,29,7,5,23,"18.3"
"160.703","Garfield Smith",25,27,2,2,27,"3.7"
"160.706","Greg Smith",22,29,7,4,24,"11.7"
"160.709","Greg Smith",21,25,4,3,22,"6"
"160.712","Ish Smith",22,29,7,11,27,"14.7"
"160.715","J.R. Smith",19,32,13,6,27,"18.1"
"160.717","Jabari Smith",23,27,4,5,24,"Did Not Play (other pro league—Spain)"
"160.720","Jason Smith",21,31,10,7,25,"Did Not Play (injury—knee)"
"160.723","Jerry Smith",24,24,0,1,24,"1.4"
"160.726","Jim Smith",23,24,1,2,23,"2.9"
"160.729","Joe Smith",20,35,15,13,21,"18.7"
"160.732","John Smith",24,25,1,4,24,"7.9"
"160.735","Josh Smith",19,32,13,7,26,"Did Not Play"
"160.737","Keith Smith",22,22,0,1,22,"3.3"
"160.740","Ken Smith",22,22,0,1,22,"4.3"
"160.743","Kenny Smith",22,31,9,7,25,"17.7"
"160.746","LaBradford Smith",22,24,2,3,23,"9.3"
"160.749","Larry Smith",23,35,12,3,27,"11.1"
"160.752","Leon Smith",21,23,2,3,21,"Did Not Play (other pro league—CBA)"
"160.754","Michael Smith",24,29,5,5,29,"Did Not Play (other pro league—Italy)"
"160.757","Michael Smith",22,28,6,4,22,"6.9"
"160.760","Mike Smith",24,24,0,1,24,"3"
"160.763","Nolan Smith",23,24,1,1,23,"3.8"
"160.766","Otis Smith",23,28,5,4,27,"13.9"
"160.769","Pete Smith",NA,NA,NA,1,NA,"0.8"
"160.771","Phil Smith",22,30,8,4,23,"20"
"160.774","Randy Smith",23,34,11,6,29,"24.6"
"160.777","Reggie Smith",22,23,1,1,23,"1.8"
"160.780","Robert Smith",22,29,7,9,25,"Did Not Play (other pro league—CBA)"
"160.783","Russ Smith",23,24,1,3,23,"4.2"
"160.786","Sam Smith",24,27,3,4,24,"9.8"
"160.789","Sam Smith",24,25,1,2,25,"8.6"
"160.792","Steve Smith",22,35,13,7,25,"20.5"
"160.795","Steven Smith",23,23,0,1,23,"0.6"
"160.798","Stevin Smith",25,25,0,1,25,"1.8"
"160.801","Theron Smith",23,24,1,2,24,"3.2"
"160.804","Tony Smith",22,32,10,9,25,"Did Not Play (other pro league—Spain)"
"160.807","William Smith",22,23,1,1,22,"8.3"
"160.810","Willie Smith",23,26,3,4,26,"4.8"
"160.813","Rik Smits",22,33,11,1,29,"18.5"
"160.816","Mike Smrek",23,29,6,6,26,"4.5"
"160.819","Joe Smyth",24,24,0,3,24,"3.6"
"160.822","Tony Snell",22,26,4,2,25,"8.5"
"160.825","Eric Snow",22,34,12,4,29,"12.9"
"160.828","Dick Snyder",22,34,12,5,26,"19.4"
"160.831","Kirk Snyder",21,24,3,5,24,"8.4"
"160.834","Chips Sobek",29,29,0,1,29,"5.8"
"160.837","Ricky Sobers",23,33,10,5,25,"18.2"
"160.840","Ron Sobie",22,25,3,3,23,"11.5"
"160.843","Mike Sojourner",21,23,2,1,21,"11.7"
"160.846","Willie Sojourner",23,26,3,2,24,"7.5"
"160.849","Will Solomon",23,30,7,7,23,"Did Not Play (other pro league—Turkey)"
"160.852","Willie Somerset",23,26,3,5,26,"Did Not Play"
"160.855","Darius Songaila",25,32,7,5,27,"9.2"
"160.858","Dave Sorenson",22,24,2,3,22,"11.3"
"160.861","James Southerland",23,23,0,3,23,"4.7"
"160.864","Gino Sovran",22,22,0,1,22,"1.8"
"160.867","Pape Sow",23,25,2,1,24,"3.5"
"160.870","Ken Spain",24,24,0,1,24,"2.2"
"160.873","Jim Spanarkel",22,26,4,2,23,"14.4"
"160.876","Vassilis Spanoulis",24,24,0,1,24,"2.7"
"160.878","Daniel Sparks",23,24,1,1,23,"6.5"
"160.881","Guy Sparrow",25,27,2,3,25,"11.1"
"160.884","Rory Sparrow",22,33,11,8,24,"12.6"
"160.887","Odie Spears",24,32,8,6,25,"Did Not Play (other pro league—NPBL)"
"160.890","Art Spector",26,29,3,1,26,"6"
"160.893","Marreese Speights",21,30,9,7,27,"10.4"
"160.896","Andre Spencer",28,29,1,4,28,"11"
"160.899","Elmore Spencer",23,27,4,5,24,"8.9"
"160.903","Felton Spencer",23,34,11,7,27,"9.3"
"160.906","Lou Spicer",24,24,0,1,24,"0.3"
"160.909","Craig Spitzer",22,22,0,1,22,"1.8"
"160.912","Tiago Splitter",26,32,6,3,28,"10.3"
"160.914","Art Spoelstra",22,25,3,4,23,"8.5"
"160.917","Bruce Spraggins",NA,NA,NA,1,NA,"12.2"
"160.919","Latrell Sprewell",22,34,12,3,26,"24.2"
"160.922","Larry Spriggs",22,26,4,3,25,"6.7"
"160.925","Jim Springer",22,22,0,1,22,"0.5"
"160.927","Jim Spruill",25,25,0,1,25,"2"
"160.930","Ryan Stack",23,24,1,1,23,"2.6"
"160.933","Jerry Stackhouse",21,38,17,9,26,"29.8"
"160.936","Kevin Stacom",23,30,7,5,26,"Did Not Play"
"160.940","Erv Staggs",21,21,0,1,21,"8.5"
"160.943","Bud Stallworth",23,27,4,2,25,"9.9"
"160.946","Dave Stallworth",24,33,9,5,25,"Did Not Play (illness—heart condition)"
"160.949","Ed Stanczak",28,29,1,2,28,"9.1"
"160.951","Terence Stansbury",23,25,2,2,23,"7.1"
"160.954","John Starks",23,36,13,6,28,"Did Not Play (other pro league—CBA, WBL)"
"160.957","Keith Starr",22,22,0,1,22,"0.8"
"160.960","Nik Stauskas",21,24,3,4,23,"9.5"
"160.963","Larry Staverman",22,27,5,6,26,"Did Not Play (other pro league—ABL)"
"160.966","Larry Steele",22,30,8,1,27,"10.3"
"160.969","Matt Steigenga",26,26,0,1,26,"1.5"
"160.972","Vladimir Stepania",22,27,5,4,26,"5.6"
"160.974","D.J. Stephens",23,23,0,1,23,"2.3"
"160.977","Everette Stephens",22,24,2,3,24,"Did Not Play (other pro league—CBA)"
"160.980","Jack Stephens",22,22,0,1,22,"10.3"
"160.983","Joe Stephens",24,27,3,3,25,"Did Not Play (other pro league—CBA)"
"160.987","Lance Stephenson",20,27,7,7,25,"14.2"
"160.990","Alex Stepheson",28,28,0,3,28,"5"
"160.994","Brook Steppe",23,29,6,7,27,"Did Not Play (other pro league—CBA)"
"160.997","Barry Stevens",30,30,0,1,30,"1"
"160.1000","Wayne Stevens",23,23,0,1,23,"1.6"
"160.1003","DeShawn Stevenson",19,31,12,7,22,"11.4"
"160.1005","Dennis Stewart",23,23,0,3,23,"3.6"
"160.1008","Kebu Stewart",24,24,0,1,24,"2.7"
"160.1012","Larry Stewart",23,28,5,3,23,"Did Not Play (other pro league—CBA, Spain)"
"160.1015","Michael Stewart",22,29,7,6,22,"4.6"
"160.1018","Norm Stewart",22,22,0,1,22,"2"
"160.1021","Greg Stiemsma",26,29,3,4,27,"4"
"160.1024","Steve Stipanovich",23,27,4,1,24,"13.7"
"160.1027","Bryant Stith",22,31,9,3,26,"14.9"
"160.1030","Sam Stith",24,24,0,1,24,"4.4"
"160.1033","Tom Stith",24,24,0,1,24,"3.1"
"160.1036","Alex Stivrins",23,30,7,9,30,"Did Not Play (other pro league—Italy)"
"160.1040","David Stockton",23,26,3,3,26,"Did Not Play"
"160.1043","John Stockton",22,40,18,1,27,"17.2"
"160.1046","Peja Stojakovic",21,33,12,7,26,"24.2"
"160.1048","Ed Stokes",26,26,0,1,26,"0.8"
"160.1051","Greg Stokes",22,26,4,3,22,"Did Not Play (other pro league—Italy)"
"160.1054","Jarnell Stokes",21,23,2,4,21,"3"
"160.1057","Maurice Stokes",22,24,2,2,24,"16.9"
"160.1060","Art Stolkey",26,26,0,1,26,"4.4"
"160.1063","Randy Stoll",NA,NA,NA,1,NA,"5.7"
"160.1065","Diamond Stone",19,19,0,1,19,"1.4"
"160.1068","George Stone",22,25,3,4,23,"16"
"160.1071","Julyan Stone",23,29,6,4,24,"Did Not Play"
"160.1074","Awvee Storey",27,30,3,4,30,"Did Not Play (other pro league—D-League)"
"160.1078","Damon Stoudamire",22,34,12,5,23,"20.2"
"160.1081","Salim Stoudamire",23,25,2,1,23,"9.7"
"160.1084","Amar'e Stoudemire",20,33,13,5,22,"26"
"160.1086","Paul Stovall",24,25,1,2,25,"7.7"
"160.1089","D.J. Strawberry",22,22,0,1,22,"2.2"
"160.1092","Joe Strawder",25,27,2,1,26,"9.5"
"160.1095","Bill Stricker",23,23,0,1,23,"4"
"160.1098","Erick Strickland",23,31,8,7,26,"12.8"
"160.1101","Mark Strickland",24,32,8,8,27,"Did Not Play (other pro league—CBA)"
"160.1104","Rod Strickland",22,38,16,11,28,"18.9"
"160.1107","Roger Strickland",23,23,0,1,23,"2"
"160.1110","John Stroeder",29,30,1,4,29,"1.9"
"160.1113","Derek Strong",23,32,9,6,29,"12.7"
"160.1116","Lamont Strothers",23,24,1,2,24,"5.6"
"160.1119","John Stroud",23,23,0,1,23,"2.8"
"160.1122","Red Stroud",26,26,0,1,26,"2.9"
"160.1125","Rodney Stuckey",21,30,9,2,23,"16.6"
"160.1128","Gene Stump",24,26,2,4,25,"8.5"
"160.1131","Stan Stutz",26,28,2,2,26,"8"
"160.1134","Gary Suiter",26,26,0,1,26,"1.4"
"160.1137","Jared Sullinger",20,24,4,2,21,"13.3"
"160.1140","DaJuan Summers",22,25,3,3,24,"4.5"
"160.1143","Edmond Sumner",22,22,0,1,22,"2"
"160.1146","Barry Sumpter",23,23,0,1,23,"0"
"160.1150","Don Sunderlage",24,25,1,2,24,"11.2"
"160.1153","Bruno Sundov",18,24,6,6,20,"3.9"
"160.1155","Jon Sundvold",22,30,8,3,25,"11.2"
"160.1158","Bob Sura",22,31,9,6,30,"14.7"
"160.1161","Dick Surhoff",23,24,1,2,24,"4.2"
"160.1164","George Sutor",24,26,2,5,25,"5.5"
"160.1167","Dane Suttle",22,23,1,1,22,"6.5"
"160.1170","Greg Sutton",24,28,4,6,28,"Did Not Play (other pro league—Greece)"
"160.1173","Keith Swagerty",23,24,1,2,23,"12.7"
"160.1176","Bennie Swain",25,25,0,1,25,"4.6"
"160.1179","Caleb Swanigan",20,20,0,1,20,"2.3"
"160.1182","Norm Swanson",23,23,0,1,23,"1.6"
"160.1185","Dan Swartz",28,28,0,1,28,"4.5"
"160.1188","Mike Sweetney",21,24,3,2,22,"8.4"
"160.1191","Robert Swift",19,23,4,3,20,"Did Not Play (injury—knee)"
"160.1193","Skeeter Swift",23,27,4,6,24,"13.7"
"160.1196","Stromile Swift",21,29,8,6,22,"11.8"
"160.1199","Aaron Swinson",24,24,0,1,24,"2.7"
"160.1202","Pape Sy",22,22,0,1,22,"2.3"
"160.1204","Buck Sydnor",25,25,0,1,25,"1"
"160.1207","Larry Sykes",22,22,0,1,22,"0"
"160.1210","Brett Szabo",28,28,0,1,28,"2.2"
"160.1213","Wally Szczerbiak",22,31,9,5,28,"20.1"
"160.1216","Walt Szczerbiak",22,22,0,1,22,"6.3"
"167.36","Zan Tabak",24,30,6,6,25,"Did Not Play (other pro league—Turkey)"
"167.38","Yuta Tabuse",24,24,0,1,24,"1.8"
"167.41","Chris Taft",20,20,0,1,20,"2.8"
"167.44","Sid Tanenbaum",22,23,1,3,22,"10.1"
"167.47","Dragan Tarlac",27,27,0,1,27,"2.4"
"167.49","Roy Tarpley",22,30,8,2,26,"Did Not Play (suspended—substance abuse)"
"167.52","Levern Tart",25,28,3,7,25,"26.9"
"167.55","Earl Tatum",23,26,3,6,24,"14.4"
"167.58","Jayson Tatum",19,19,0,1,19,"13.9"
"167.61","Edy Tavares",23,24,1,3,24,"6"
"167.63","Anthony Taylor",23,23,0,1,23,"6.9"
"167.66","Brian Taylor",21,30,9,4,25,"17"
"167.69","Donell Taylor",23,24,1,1,23,"2.7"
"167.73","Fatty Taylor",23,30,7,4,26,"10.1"
"167.76","Fred Taylor",22,23,1,3,22,"5.5"
"167.79","Isaiah Taylor",22,23,1,2,23,"6.6"
"167.82","Jay Taylor",22,22,0,1,22,"3"
"167.85","Jeff Taylor",23,27,4,3,23,"Did Not Play"
"167.88","Jeffery Taylor",23,25,2,2,24,"8"
"167.91","Jermaine Taylor",23,24,1,3,24,"7.1"
"167.94","Johnny Taylor",23,25,2,3,24,"5.8"
"167.98","Leonard Taylor",23,23,0,1,23,"1.1"
"167.101","Maurice Taylor",21,30,9,6,23,"Did Not Play (injury)"
"167.104","Mike Taylor",23,23,0,1,23,"5.7"
"167.107","Oliver Taylor",23,26,3,4,25,"13.7"
"167.110","Ronald Taylor",22,24,2,5,22,"5"
"167.113","Tyshawn Taylor",22,23,1,1,23,"3.9"
"167.116","Vince Taylor",22,22,0,1,22,"3.1"
"167.119","Terry Teagle",22,32,10,5,29,"16.1"
"167.122","Jeff Teague",21,29,8,3,25,"16.5"
"167.125","Marquis Teague",19,24,5,5,24,"Did Not Play"
"167.128","Mirza Teletovic",27,32,5,3,30,"12.2"
"167.130","Sebastian Telfair",19,29,10,10,23,"Did Not Play"
"167.132","Collis Temple",22,22,0,1,22,"1.8"
"167.135","Garrett Temple",23,31,8,8,31,"Did Not Play (other pro league—Italy)"
"167.138","Milos Teodosic",30,30,0,1,30,"9.5"
"167.140","Ira Terrell",22,24,2,5,22,"Did Not Play (injury)"
"167.143","Carlos Terry",24,26,2,1,24,"7.2"
"167.146","Chuck Terry",22,26,4,5,26,"5"
"167.149","Claude Terry",23,28,5,5,27,"9.3"
"167.152","Jason Terry",22,40,18,6,23,"19.7"
"167.155","Hasheem Thabeet",22,26,4,5,22,"3.1"
"167.158","Tom Thacker",24,31,7,4,29,"Did Not Play (retired)"
"167.161","Floyd Theard",25,25,0,1,25,"3.8"
"167.164","Daniel Theis",25,25,0,1,25,"5.3"
"167.166","Reggie Theus",21,33,12,7,25,"23.8"
"167.169","Peter Thibeaux",23,24,1,1,24,"5.5"
"167.172","Bill Thieben",21,22,1,2,21,"4.1"
"167.175","Justus Thigpen",22,26,4,4,22,"Did Not Play"
"167.178","David Thirdkill",22,26,4,6,24,"7.5"
"167.181","Adonis Thomas",20,20,0,3,20,"3.5"
"167.184","Billy Thomas",29,32,3,5,29,"Did Not Play (other pro league—Serbia, USBL)"
"167.187","Carl Thomas",22,28,6,6,22,"Did Not Play (other pro league—CBA)"
"167.190","Charles Thomas",22,22,0,1,22,"1.3"
"167.193","Etan Thomas",23,32,9,4,25,"Did Not Play (illness—heart condition)"
"167.196","Irving Thomas",25,25,0,1,25,"1.8"
"167.200","Isaiah Thomas",22,28,6,6,27,"28.9"
"167.203","Isiah Thomas",20,32,12,1,21,"22.9"
"167.206","Jamel Thomas",26,27,1,4,26,"3.7"
"167.209","James Thomas",24,25,1,5,24,"2.7"
"167.212","Jim Thomas",23,30,7,6,24,"Did Not Play (other pro league—WBL)"
"167.215","Joe Thomas",22,22,0,1,22,"1.4"
"167.218","John Thomas",22,30,8,10,23,"Did Not Play (other pro league—Domincan Republic, China)"
"167.221","Kenny Thomas",22,32,10,4,27,"14.5"
"167.224","Kurt Thomas",23,40,17,10,30,"14"
"167.227","Lance Thomas",23,29,6,5,26,"8.3"
"167.230","Malcolm Thomas",23,26,3,6,26,"2.6"
"167.234","Ronald Thomas",22,25,3,1,22,"4.7"
"167.237","Terry Thomas",22,22,0,1,22,"2.8"
"167.240","Tim Thomas",20,32,12,8,26,"15.8"
"167.243","Tyrus Thomas",20,28,8,5,22,"Did Not Play"
"167.246","Willis Thomas",NA,NA,NA,3,NA,"12.3"
"167.248","Trey Thompkins",21,21,0,1,21,"2.4"
"167.251","Bernard Thompson",22,26,4,3,23,"8.5"
"167.254","Billy Thompson",23,28,5,3,26,"11"
"167.257","Brooks Thompson",24,27,3,6,26,"6.8"
"167.261","Corny Thompson",22,22,0,1,22,"2.8"
"167.264","David Thompson",21,29,8,3,23,"27.2"
"167.267","Dijon Thompson",22,23,1,2,22,"2.8"
"167.270","George Thompson",22,27,5,4,24,"27"
"167.273","Hollis Thompson",22,25,3,3,24,"9.8"
"167.276","Jack Thompson",22,22,0,1,22,"1"
"167.279","Jason Thompson",22,29,7,4,23,"12.5"
"167.282","John Thompson",23,24,1,1,23,"3.6"
"167.285","Kevin Thompson",22,22,0,1,22,"0.9"
"167.288","Klay Thompson",21,27,6,1,26,"22.3"
"167.291","LaSalle Thompson",21,35,14,6,27,"15"
"167.294","Mychal Thompson",24,36,12,5,27,"Did Not Play (injury—leg)"
"167.297","Mychel Thompson",23,23,0,1,23,"3.6"
"167.300","Paul Thompson",22,24,2,4,23,"10.5"
"167.303","Stephen Thompson",23,23,0,3,23,"2"
"167.306","Tristan Thompson",20,26,6,1,21,"11.7"
"167.309","Skip Thoren",24,26,2,2,25,"16.7"
"167.312","Rod Thorn",22,29,7,5,26,"15.2"
"167.315","Al Thornton",24,27,3,4,25,"16.8"
"167.318","Bob Thornton",23,33,10,7,23,"Did Not Play (other pro league—Italy)"
"167.321","Dallas Thornton",22,23,1,1,23,"8.8"
"167.324","Marcus Thornton",22,29,7,8,23,"21.3"
"167.327","Sindarius Thornwell",23,23,0,1,23,"3.9"
"167.330","Otis Thorpe",22,38,16,10,25,"20.8"
"167.333","Sedale Threatt",22,35,13,6,30,"15.1"
"167.336","Nate Thurmond",22,35,13,5,28,"21.9"
"167.339","Mel Thurston",29,29,0,1,29,"5.6"
"167.342","Hal Tidrick",33,33,0,3,33,"9.7"
"167.345","Dan Tieman",22,22,0,1,22,"1.2"
"167.348","Darren Tillis",22,23,1,4,22,"4.1"
"167.351","Jack Tingle",23,24,1,2,23,"2.4"
"167.354","George Tinsley",23,25,2,5,23,"Did Not Play"
"167.357","Jamaal Tinsley",23,35,12,4,26,"Did Not Play"
"167.360","Wayman Tisdale",21,32,11,4,25,"22.3"
"167.363","Mike Tobey",22,22,0,1,22,"1"
"167.366","Mike Todorovich",26,27,1,3,26,"13.6"
"167.369","Ray Tolbert",23,30,7,9,24,"Did Not Play (other pro league—Italy)"
"167.372","Tom Tolbert",23,29,6,4,24,"8.8"
"167.376","Anthony Tolliver",23,32,9,10,24,"12.3"
"167.379","Dean Tolson",23,26,3,2,25,"Did Not Play (other pro league—EBA)"
"167.382","Rudy Tomjanovich",22,32,10,2,25,"24.5"
"167.385","Andrew Toney",23,30,7,1,26,"20.4"
"167.388","Sedric Toney",23,31,8,9,23,"Did Not Play (other pro league—CBA)"
"167.391","Andy Tonkovich",26,26,0,1,26,"2.6"
"167.394","Andy Toolson",25,30,5,4,25,"Did Not Play (other pro league—Spain)"
"167.397","Jack Toomay",25,27,2,6,25,"10.9"
"167.400","Bernard Toone",23,23,0,1,23,"2.4"
"167.403","Irv Torgoff",29,31,2,4,29,"8.4"
"167.406","Gene Tormohlen",25,32,7,3,29,"Did Not Play (retired)"
"167.409","Oscar Torres",25,26,1,2,25,"6"
"167.411","Bill Tosheff",25,27,2,2,26,"11.3"
"167.414","Bob Tough",28,29,1,4,28,"8.8"
"167.417","Axel Toupane",23,24,1,4,24,"5.5"
"167.419","Monte Towe",22,23,1,2,22,"3"
"167.422","Keith Tower",23,26,3,3,25,"2.4"
"167.425","Blackie Towery",28,29,1,4,28,"11.5"
"167.428","Linton Townes",23,25,2,5,23,"4.5"
"167.431","Karl-Anthony Towns",20,22,2,1,21,"25.1"
"167.434","Raymond Townsend",23,26,3,3,24,"Did Not Play (other pro league—CBA)"
"167.437","George Trapp",23,28,5,2,24,"11.3"
"167.440","John Trapp",23,27,4,5,27,"10.7"
"167.443","Robert Traylor",21,27,6,4,23,"5.7"
"167.446","Gary Trent",21,29,8,5,24,"16"
"167.449","Jeff Trepagnier",22,24,2,2,23,"5.6"
"167.452","John Tresvant",25,33,8,7,29,"13.6"
"167.455","Dick Triptow",26,27,1,2,26,"6.1"
"167.458","Kelly Tripucka",22,31,9,3,23,"26.5"
"167.461","Ansley Truitt",22,22,0,1,22,"2.4"
"167.464","Cezary Trybanski",23,24,1,4,23,"0.9"
"167.466","Jake Tsakalidis",21,27,6,4,22,"7.3"
"167.468","John Tschogl",22,24,2,2,24,"3.1"
"167.471","Lou Tsioropoulos",26,28,2,1,27,"7.7"
"167.474","Nikoloz Tskitishvili",19,22,3,5,19,"3.9"
"167.476","Al Tucker",24,28,4,6,24,"13.1"
"167.479","Alando Tucker",23,25,2,3,24,"4.6"
"167.482","Anthony Tucker",25,25,0,1,25,"3.9"
"167.486","Jim Tucker",22,24,2,1,22,"5.3"
"167.489","P.J. Tucker",21,32,11,9,28,"Did Not Play (other pro league—Ukraine)"
"167.492","Trent Tucker",23,33,10,3,27,"11.4"
"167.495","Ronny Turiaf",23,32,9,8,25,"6.6"
"167.498","Mirsad Turkcan",23,23,0,3,23,"2.9"
"167.500","Hedo Turkoglu",21,35,14,7,28,"19.5"
"167.502","Andre Turner",22,27,5,8,26,"5.9"
"167.505","Bill Turner",23,28,5,6,24,"7.8"
"167.508","Elston Turner",22,29,7,3,22,"8.3"
"167.511","Evan Turner",22,29,7,5,25,"17.4"
"167.514","Gary Turner",NA,NA,NA,1,NA,"3"
"167.516","Henry Turner",23,28,5,4,23,"Did Not Play (other pro league—Italy)"
"167.519","Herschell Turner",29,29,0,3,29,"3.6"
"167.522","Jack Turner",24,24,0,1,24,"4.3"
"167.525","Jack Turner",22,22,0,1,22,"4.8"
"167.528","Jeff Turner",22,33,11,3,28,"Did Not Play (other pro league—Italy)"
"167.531","John Turner",24,24,0,1,24,"2.8"
"167.535","Myles Turner",19,21,2,1,20,"14.5"
"167.538","Wayne Turner",23,23,0,1,23,"1.3"
"167.541","Melvin Turpin",24,29,5,4,25,"Did Not Play (other pro league—Spain)"
"167.544","Dave Twardzik",22,29,7,2,24,"13.6"
"167.547","Jack Twyman",21,31,10,2,25,"31.2"
"167.550","B.J. Tyler",23,23,0,1,23,"3.5"
"167.554","Jeremy Tyler",20,22,2,4,20,"4.9"
"167.556","Terry Tyler",22,32,10,3,24,"13.4"
"167.559","Charlie Tyra",22,26,4,2,24,"12.8"
"174.36","Edwin Ubiles",25,25,0,1,25,"3.5"
"174.39","Ekpe Udoh",23,30,7,6,24,"Did Not Play"
"174.43","Ime Udoka",26,33,7,6,29,"Did Not Play (other pro league—France, Spain)"
"174.47","Beno Udrih",22,34,12,9,28,"13.7"
"174.49","Roko Ukic",24,25,1,2,24,"4.2"
"174.51","Tyler Ulis",21,22,1,1,22,"7.8"
"174.54","Wes Unseld",22,34,12,3,23,"16.2"
"174.57","Hal Uplinger",24,24,0,1,24,"3.7"
"174.60","Kelvin Upshaw",26,28,2,5,26,"7"
"174.63","Jarrod Uthoff",23,23,0,1,23,"4.4"
"174.66","Ben Uzoh",22,23,1,4,23,"4.8"
"181.36","Stephen Vacendak",23,25,2,4,24,"12.4"
"181.39","Jonas Valanciunas",20,25,5,1,23,"12.8"
"181.41","Darnell Valentine",22,31,9,5,23,"Did Not Play"
"181.44","Denzel Valentine",23,24,1,1,24,"10.2"
"181.47","Ronnie Valentine",23,23,0,1,23,"3.5"
"181.50","John Vallely",22,23,1,3,23,"5.9"
"181.53","Dick Van Arsdale",22,33,11,2,27,"21.9"
"181.56","Tom Van Arsdale",22,33,11,7,27,"22.9"
"181.59","Butch van Breda Kolff",24,27,3,1,26,"7"
"181.62","Jan van Breda Kolff",23,31,8,6,25,"10.2"
"181.65","Nick Van Exel",22,34,12,7,30,"21.4"
"181.69","Keith Van Horn",22,30,8,6,23,"21.8"
"181.72","Norm Van Lier",22,31,9,4,23,"16"
"181.75","Dennis Van Zant",23,23,0,1,23,"2"
"181.78","Gene Vance",24,28,4,3,25,"10.3"
"181.81","Logan Vander Velden",24,24,0,1,24,"0.6"
"181.84","Ernie Vandeweghe",21,27,6,2,24,"Did Not Play (other—medical school)"
"181.87","Kiki Vandeweghe",22,34,12,5,25,"29.4"
"181.90","Nick Vanos",22,23,1,1,22,"4.9"
"181.93","David Vanterpool",27,27,0,1,27,"5.5"
"181.96","Fred VanVleet",22,23,1,1,23,"8.6"
"181.99","Ratko Varda",22,22,0,1,22,"5"
"181.101","Anderson Varejao",22,34,12,3,30,"14.1"
"181.103","Jarvis Varnado",24,25,1,5,25,"4.3"
"181.106","Greivis Vasquez",24,30,6,7,26,"13.9"
"181.109","Chico Vaughn",22,29,7,5,27,"19.9"
"181.112","David Vaughn",22,23,1,1,22,"11.7"
"181.115","David Vaughn",22,25,3,5,24,"5.2"
"181.118","Jacque Vaughn",22,33,11,5,26,"6.6"
"181.121","Rashad Vaughn",19,21,2,4,20,"3.5"
"181.124","Virgil Vaughn",28,28,0,1,28,"2.6"
"181.127","Loy Vaught",22,32,10,5,26,"17.5"
"181.130","Bob Verga",22,28,6,9,24,"Did Not Play"
"181.133","Pete Verhoeven",22,27,5,4,22,"4.9"
"181.136","Jan Vesely",21,23,2,3,21,"4.7"
"181.138","Gundars Vetra",25,25,0,1,25,"3.5"
"181.140","Joao Vianna",25,25,0,1,25,"2"
"181.142","Charlie Villanueva",21,31,10,4,24,"16.2"
"181.145","Jay Vincent",22,30,8,7,22,"21.4"
"181.148","Sam Vincent",22,28,6,5,24,"13"
"181.151","Marcus Vinicius",22,23,1,2,23,"2.2"
"181.153","Fred Vinson",24,29,5,6,29,"Did Not Play (other pro league—USBL)"
"181.156","Claude Virden",25,25,0,1,25,"9.9"
"181.159","Gary Voce",24,24,0,1,24,"2"
"181.162","Floyd Volker",28,28,0,3,28,"9.6"
"181.165","Alexander Volkov",25,27,2,2,27,"Did Not Play (injury)"
"181.167","Whitey Von Nieda",27,27,0,3,27,"6.2"
"181.170","Noah Vonleh",19,22,3,4,22,"6.9"
"181.173","Jake Voskuhl",23,31,8,5,26,"6.6"
"181.176","Danny Vranes",23,29,6,2,25,"8.4"
"181.179","Slavko Vranes",21,21,0,1,21,"0"
"181.181","Stojko Vrankovic",27,35,8,4,33,"Did Not Play (other pro league—Greece)"
"181.183","Brett Vroman",25,25,0,1,25,"3.1"
"181.187","Jackson Vroman",23,24,1,4,23,"5.4"
"181.190","Nikola Vucevic",21,27,6,2,24,"19.3"
"181.193","Sasha Vujacic",20,32,12,6,26,"Did Not Play"
"188.36","Dwyane Wade",22,36,14,4,27,"30.2"
"188.39","Mark Wade",22,24,2,3,22,"Did Not Play (other pro league—CBA)"
"188.43","Von Wafer",20,26,6,9,23,"Did Not Play (other pro league—Greece)"
"188.46","Clint Wager",30,30,0,1,30,"2.3"
"188.49","Dajuan Wagner",19,23,4,3,19,"Did Not Play (illness—colitis)"
"188.52","Danny Wagner",27,27,0,1,27,"6.3"
"188.55","Milt Wagner",24,27,3,4,27,"Did Not Play (other pro league—CBA)"
"188.58","Phillip Wagner",23,23,0,1,23,"3"
"188.61","Dion Waiters",21,26,5,4,22,"15.9"
"188.64","Granville Waiters",23,27,4,3,23,"3.6"
"188.67","Andre Wakefield",24,25,1,4,24,"2.4"
"188.70","Neal Walk",21,28,7,4,24,"20.2"
"188.73","Andy Walker",21,21,0,1,21,"4.5"
"188.76","Antoine Walker",20,31,11,6,24,"23.4"
"188.79","Brady Walker",27,30,3,4,27,"8.3"
"188.82","Chet Walker",22,34,12,3,30,"22"
"188.85","Darrell Walker",22,31,9,6,23,"13.5"
"188.88","Foots Walker",23,32,9,2,27,"10.1"
"188.91","Henry Walker",21,27,6,5,22,"Did Not Play"
"188.94","Horace Walker",24,24,0,1,24,"6.7"
"188.97","Jimmy Walker",23,31,8,5,27,"21.3"
"188.100","Kemba Walker",21,27,6,2,26,"23.2"
"188.103","Kenny Walker",22,30,8,4,22,"Did Not Play (other pro league—Spain)"
"188.106","Phil Walker",21,21,0,1,21,"4.5"
"188.109","Samaki Walker",20,29,9,6,21,"8.9"
"188.112","Wally Walker",22,29,7,4,27,"9.9"
"188.115","John Wall",20,27,7,1,26,"23.1"
"188.118","Ben Wallace",22,37,15,7,30,"9.7"
"188.121","Gerald Wallace",19,32,13,7,25,"19.4"
"188.124","John Wallace",22,29,7,6,23,"Did Not Play (other pro league—Greece)"
"188.127","Rasheed Wallace",21,38,17,8,29,"Did Not Play (retired)"
"188.130","Red Wallace",28,28,0,3,28,"11.5"
"188.133","Tyrone Wallace",23,23,0,1,23,"9.7"
"188.136","Dwight Waller",23,26,3,3,24,"Did Not Play"
"188.139","Jamie Waller",23,23,0,1,23,"4.7"
"188.145","Jim Walsh",27,27,0,1,27,"2"
"188.148","Matt Walsh",23,23,0,1,23,"1"
"188.151","Rex Walters",23,29,6,4,26,"6.8"
"188.155","Paul Walther",22,27,5,5,24,"12.2"
"188.158","Isaac Walthour",23,23,0,1,23,"0.5"
"188.160","Bill Walton",22,34,12,5,25,"Did Not Play (injury—foot)"
"188.163","Derrick Walton",22,22,0,1,22,"1.8"
"188.166","Lloyd Walton",23,27,4,2,25,"5"
"188.169","Luke Walton",23,32,9,3,26,"11.4"
"188.172","Bobby Wanzer",27,35,8,1,30,"15.7"
"188.175","Perry Warbington",22,22,0,1,22,"2"
"188.178","Charlie Ward",24,34,10,4,33,"8.7"
"188.181","Gerry Ward",22,25,3,4,25,"4.2"
"188.184","Henry Ward",24,25,1,2,24,"5.4"
"188.187","Casper Ware",24,24,0,1,24,"5.3"
"188.190","Jim Ware",22,24,2,3,24,"7"
"188.193","Ben Warley",26,33,7,7,31,"17.4"
"188.196","Bob Warlick",24,28,4,6,28,"10"
"188.199","Cornell Warner",22,28,6,5,26,"7.6"
"188.202","Jameel Warney",24,24,0,1,24,"5.7"
"188.205","Bob Warren",22,29,7,8,25,"17.4"
"188.208","John Warren",22,26,4,2,23,"11.5"
"188.211","T.J. Warren",21,24,3,1,24,"19.6"
"188.214","Willie Warren",21,21,0,1,21,"1.9"
"188.217","Bryan Warrick",23,26,3,5,26,"7"
"188.220","Hakim Warrick",23,30,7,7,24,"12.7"
"188.223","Chris Washburn",21,22,1,3,22,"4.1"
"188.226","Bobby Washington",22,24,2,2,23,"7.4"
"188.229","Darius Washington",22,22,0,1,22,"2.9"
"188.232","Donald Washington",22,23,1,2,23,"4"
"188.235","Duane Washington",23,28,5,5,23,"Did Not Play (suspended—substance abuse)"
"188.238","Eric Washington",23,24,1,1,23,"7.7"
"188.241","Jim Washington",22,32,10,6,25,"14"
"188.244","Kermit Washington",22,36,14,7,28,"Did Not Play (retired)"
"188.247","Pearl Washington",23,25,2,2,24,"9.3"
"188.250","Richard Washington",21,26,5,5,21,"13"
"188.253","Stan Washington",23,23,0,1,23,"0"
"188.256","Trooper Washington",23,28,5,6,24,"15"
"188.259","Wilson Washington",22,23,1,3,22,"8.8"
"188.262","Darryl Watkins",23,27,4,5,27,"Did Not Play (other pro league)"
"188.265","Bobby Watson",24,24,0,3,24,NA
"188.268","C.J. Watson",23,32,9,5,25,"10.3"
"188.271","Earl Watson",22,34,12,8,26,"11.5"
"188.274","Jamie Watson",22,26,4,5,24,"Did Not Play"
"188.277","Ron Watts",22,23,1,1,22,"2"
"188.280","Samuel Watts",22,22,0,1,22,"5.2"
"188.283","Slick Watts",22,27,5,4,24,"13"
"188.286","Maalik Wayns",21,22,1,3,21,"3.3"
"188.289","David Wear",24,24,0,1,24,"0"
"188.293","Travis Wear",24,27,3,3,27,"Did Not Play"
"188.297","Clarence Weatherspoon",22,34,12,7,23,"18.4"
"188.300","Nick Weatherspoon",23,29,6,6,28,"13.8"
"188.303","Kyle Weaver",22,24,2,2,24,"5.6"
"188.306","James Webb",24,24,0,1,24,"1.6"
"188.309","Jeff Webb",22,23,1,3,23,"2.5"
"188.312","Marcus Webb",22,22,0,1,22,"4.3"
"188.315","Spud Webb",22,34,12,6,28,"Did Not Play (other pro league—Italy)"
"188.319","Chris Webber",20,34,14,7,27,"27.1"
"188.322","Briante Weber",23,25,2,6,23,"4.8"
"188.325","Jake Weber",28,28,0,3,28,"3.9"
"188.328","Elnardo Webster",23,23,0,3,23,"7.3"
"188.331","Jeff Webster",24,24,0,1,24,"1.6"
"188.334","Martell Webster",19,28,9,3,26,"11.4"
"188.336","Marvin Webster",23,34,11,6,25,"Did Not Play (illness—hepatitis)"
"188.339","Scott Wedman",22,34,12,5,27,"19"
"188.342","Sonny Weems",22,29,7,6,24,"Did Not Play"
"188.345","Dick Wehr",23,23,0,1,23,"1.3"
"188.348","Brant Weidner",23,23,0,1,23,"1"
"188.351","Bob Weiss",23,34,11,7,27,"11.5"
"188.354","Rick Weitzman",21,21,0,1,21,"1.3"
"188.357","Bonzi Wells",22,31,9,6,25,"17"
"188.360","Bubba Wells",23,23,0,1,23,"3.3"
"188.363","Owen Wells",24,24,0,1,24,"3"
"188.366","Ralph Wells",22,22,0,1,22,"0.7"
"188.369","Chris Welp",24,26,2,4,24,"4.8"
"188.372","Jiri Welsch",23,26,3,5,24,"9.2"
"188.374","Bill Wennington",22,36,14,4,30,"Did Not Play (other pro league—Italy)"
"188.377","Matt Wenstrom",23,23,0,1,23,"1.6"
"188.380","Robert Werdann",22,26,4,3,25,"Did Not Play (other pro league—CBA, USBL)"
"188.383","Ray Wertis",25,26,1,4,25,"5.5"
"188.386","David Wesley",23,36,13,7,30,"17.2"
"188.389","Walt Wesley",22,31,9,9,26,"17.7"
"188.392","David West",23,37,14,5,28,"21"
"188.395","Delonte West",21,28,7,5,23,"12.2"
"188.398","Doug West",22,33,11,2,25,"19.3"
"188.401","Jerry West",22,35,13,1,27,"31.3"
"188.404","Mario West",23,26,3,2,26,"3.7"
"188.407","Mark West",23,39,16,8,27,"11.8"
"188.410","Roland West",23,23,0,1,23,"1"
"188.413","Dexter Westbrook",NA,NA,NA,3,NA,"4.4"
"188.415","Russell Westbrook",20,29,9,1,28,"31.6"
"188.418","Paul Westphal",22,33,11,4,27,"25.2"
"188.421","John Wetzel",23,31,8,4,26,"Did Not Play (military service)"
"188.424","Robert Whaley",23,23,0,1,23,"2.1"
"188.429","Ennis Whatley",21,34,13,12,24,"Did Not Play (other pro league—Philippines)"
"188.432","DeJuan Wheat",24,25,1,2,25,"4.5"
"188.435","Clinton Wheeler",28,29,1,4,29,"7"
"188.438","Tyson Wheeler",23,23,0,1,23,"4"
"188.441","Skippy Whitaker",24,24,0,1,24,"0.7"
"188.444","Andrew White",24,24,0,1,24,"4.6"
"188.448","D.J. White",22,27,5,4,22,"8.9"
"188.451","Derrick White",23,23,0,1,23,"3.2"
"188.454","Eric White",22,23,1,3,22,"10.5"
"188.457","Herb White",22,22,0,1,22,"2.4"
"188.460","Hubie White",23,31,8,5,30,"Did Not Play"
"188.463","Jahidi White",22,28,6,4,24,"8.6"
"188.466","James White",24,30,6,6,24,"Did Not Play (other pro league—Turkey)"
"188.470","Jo Jo White",23,34,11,4,25,"23.1"
"188.473","Okaro White",24,25,1,1,25,"3.3"
"188.476","Randy White",22,26,4,1,25,"9.7"
"188.479","Rodney White",21,24,3,4,22,"9"
"188.482","Rory White",23,27,4,5,26,"11.7"
"188.485","Royce White",22,22,0,1,22,"0"
"188.488","Rudy White",22,27,5,5,27,"Did Not Play"
"188.491","Tony White",22,22,0,4,22,"6.2"
"188.494","Willie White",22,23,1,1,23,"4"
"188.497","Isaiah Whitehead",21,22,1,1,21,"7.4"
"188.500","Jerome Whitehead",22,32,10,7,25,"13.8"
"188.503","Donald Whiteside",27,28,1,2,27,"2.2"
"188.506","Hassan Whiteside",21,28,7,3,27,"Did Not Play"
"188.509","Dwayne Whitfield",23,23,0,1,23,"5"
"188.512","Chris Whitney",22,32,10,6,30,"10.2"
"188.515","Hank Whitney",28,30,2,5,28,"16"
"188.518","Hawkeye Whitney",23,24,1,1,23,"7.4"
"188.521","Shayne Whittington",23,24,1,1,23,"2.9"
"188.524","Sidney Wicks",22,31,9,3,22,"24.5"
"188.527","Ron Widby",22,22,0,1,22,"2.9"
"188.530","Murray Wier",23,23,0,1,23,"7.7"
"188.533","Bob Wiesenhahn",23,23,0,1,23,"2"
"188.536","Andrew Wiggins",19,22,3,1,21,"23.6"
"188.539","Mitchell Wiggins",24,32,8,5,30,"Did Not Play (suspended—substance abuse)"
"188.543","Ken Wilburn",23,24,1,5,24,"4.7"
"188.546","C.J. Wilcox",24,26,2,2,25,"3"
"188.549","Chris Wilcox",20,30,10,7,23,"14.1"
"188.552","D.C. Wilcutt",25,26,1,1,25,"2.3"
"188.555","Gene Wiley",25,30,5,5,27,"Did Not Play"
"188.558","Jacob Wiley",23,23,0,1,23,"0.8"
"188.561","Michael Wiley",23,24,1,2,24,"8.3"
"188.564","Morlon Wiley",22,28,6,6,26,"5.8"
"188.567","Win Wilfong",24,27,3,2,26,"10.1"
"188.570","Lenny Wilkens",23,37,14,4,31,"22.4"
"188.573","Bob Wilkerson",22,28,6,4,25,"13.8"
"188.576","Jamaal Wilkes",21,32,11,3,27,"22.6"
"188.579","James Wilkes",22,24,2,2,23,"5.5"
"188.582","Damien Wilkins",25,38,13,8,28,"Did Not Play"
"188.586","Dominique Wilkins",23,39,16,8,28,"Did Not Play (other pro league—Italy)"
"188.589","Eddie Lee Wilkins",22,30,8,5,30,"Did Not Play (other pro league—Italy)"
"188.592","Gerald Wilkins",22,35,13,5,23,"Did Not Play (injury)"
"188.595","Jeff Wilkins",25,30,5,3,27,"11.5"
"188.598","Dale Wilkinson",24,24,0,3,24,"1.4"
"188.601","Mike Wilks",23,30,7,11,23,"Did Not Play (injury—knee)"
"188.604","Aaron Williams",22,36,14,12,29,"Did Not Play (other pro league—CBA)"
"188.607","Al Williams",22,22,0,1,22,"3.9"
"188.610","Alan Williams",23,25,2,1,24,"7.4"
"188.613","Alvin Williams",23,32,9,5,28,"Did Not Play (injury)"
"188.616","Art Williams",28,35,7,3,28,"8.1"
"188.619","Bernie Williams",24,28,4,2,27,"12.5"
"188.622","Bob Williams",24,25,1,1,24,"3.3"
"188.625","Brandon Williams",22,27,5,6,22,"Did Not Play (other pro league—CBA)"
"188.628","Buck Williams",21,37,16,3,27,"18.3"
"188.631","C.J. Williams",27,27,0,1,27,"5.5"
"188.634","Charles Williams",24,29,5,7,24,"20.8"
"188.637","Chuck Williams",24,31,7,9,26,"17.7"
"188.640","Chuckie Williams",23,23,0,1,23,"1.7"
"188.643","Cliff Williams",23,23,0,1,23,"1.3"
"188.646","Corey Williams",22,23,1,2,23,"2.8"
"188.649","Deron Williams",21,32,11,6,26,"21.3"
"188.652","Derrick Williams",20,26,6,7,21,"12"
"188.655","Duck Williams",23,23,0,1,23,"6.6"
"188.658","Earl Williams",23,27,4,5,27,"Did Not Play"
"188.661","Elliot Williams",22,26,4,7,24,"Did Not Play"
"188.665","Eric Williams",23,34,11,8,25,"19.8"
"188.668","Fly Williams",21,21,0,1,21,"9.4"
"188.671","Frank Williams",22,24,2,2,23,"3.9"
"188.674","Freeman Williams",22,29,7,6,24,"Did Not Play (other pro league—CBA)"
"188.677","Gene Williams",22,22,0,1,22,"0"
"188.680","Gus Williams",22,33,11,5,28,"Did Not Play (holdout)"
"188.683","Guy Williams",24,25,1,2,24,"2.9"
"188.687","Hank Williams",22,22,0,1,22,"4.2"
"188.690","Herb Williams",23,40,17,5,27,"19.9"
"188.693","Hot Rod Williams",24,36,12,3,27,"16.8"
"188.696","Jason Williams",23,35,12,6,26,"Did Not Play (retired)"
"188.700","Jawad Williams",25,27,2,1,26,"4.1"
"188.703","Jay Williams",21,21,0,1,21,"9.5"
"188.706","Jayson Williams",22,30,8,2,28,"13.4"
"188.709","Jerome Williams",23,31,8,5,29,"9.7"
"188.712","John Williams",20,28,8,4,23,"Did Not Play (suspended—overweight)"
"188.715","Jordan Williams",21,21,0,1,21,"4.6"
"188.718","Justin Williams",22,23,1,3,22,"5"
"188.721","Kenny Williams",21,24,3,1,24,"6.3"
"188.724","Kevin Williams",22,27,5,7,26,"Did Not Play (other pro league—CBA)"
"188.728","Lorenzo Williams",23,30,7,8,25,"Did Not Play (injury)"
"188.731","Lou Williams",19,31,12,7,31,"22.6"
"188.733","Marcus Williams",21,24,3,3,21,"6.8"
"188.736","Marcus Williams",21,22,1,3,22,"2"
"188.739","Marvin Williams",19,31,12,3,21,"14.8"
"188.742","Matt Williams",24,24,0,1,24,"1.7"
"188.745","Micheal Williams",22,32,10,8,26,"Did Not Play (injury)"
"188.748","Mike Williams",26,26,0,3,26,"0.9"
"188.752","Milt Williams",25,29,4,5,26,"Did Not Play"
"188.755","Mo Williams",21,33,12,8,26,"17.8"
"188.758","Monty Williams",23,31,8,6,25,"9"
"188.761","Nate Williams",21,28,7,5,23,"15.5"
"188.764","Pete Williams",20,21,1,1,20,"2.8"
"188.767","Ray Williams",23,32,9,7,25,"20.9"
"188.770","Reggie Williams",23,32,9,7,27,"18.2"
"188.773","Reggie Williams",23,30,7,6,23,"Did Not Play"
"188.776","Rickey Williams",25,25,0,1,25,"3.3"
"188.780","Rob Williams",21,22,1,1,22,"10.2"
"188.783","Ron Williams",24,31,7,4,25,"14.8"
"188.786","Sam Williams",24,25,1,1,24,"4.1"
"188.789","Sam Williams",22,25,3,3,23,"8.4"
"188.792","Scott Williams",22,36,14,8,25,"7.6"
"188.795","Sean Williams",21,25,4,5,21,"Did Not Play (other pro league—D-League)"
"188.798","Shammond Williams",23,31,8,10,27,"Did Not Play (other pro league—Spain)"
"188.801","Shawne Williams",20,28,8,9,24,"Did Not Play"
"188.804","Shelden Williams",23,28,5,8,23,"5.5"
"188.807","Sly Williams",22,28,6,3,24,"13.9"
"188.810","Terrence Williams",22,25,3,5,24,"8.8"
"188.813","Travis Williams",28,29,1,1,28,"3.5"
"188.816","Troy Williams",22,23,1,4,22,"9.7"
"188.819","Walt Williams",22,32,10,7,22,"17"
"188.822","Ward Williams",25,25,0,1,25,"4.1"
"188.825","Willie Williams",24,24,0,3,24,"0.9"
"188.828","Corliss Williamson",22,33,11,5,24,"17.7"
"188.831","John Williamson",22,29,7,6,26,"29.5"
"188.834","Vann Williford",23,23,0,1,23,"3.9"
"188.837","Kevin Willis",22,44,22,11,32,"Did Not Play (retired)"
"188.840","Bill Willoughby",18,26,8,8,24,"Did Not Play"
"188.842","Dedric Willoughby",25,25,0,1,25,"7.6"
"188.846","Bob Wilson",25,25,0,1,25,"3.7"
"188.849","Bobby Wilson",NA,NA,NA,1,NA,"8.9"
"188.851","Bobby Wilson",24,27,3,3,25,"7.5"
"188.854","Bubba Wilson",24,24,0,1,24,"1.1"
"188.857","D.J. Wilson",21,21,0,1,21,"1"
"188.860","George Wilson",22,28,6,7,26,"11.6"
"188.863","Isaiah Wilson",23,24,1,2,24,"6.3"
"188.866","Jamil Wilson",27,27,0,1,27,"7"
"188.870","Jasper Wilson",21,22,1,1,22,"5.8"
"188.873","Jim Wilson",NA,NA,NA,1,NA,"1"
"188.875","Michael Wilson",24,27,3,6,25,"Did Not Play (other pro league—USBL)"
"188.878","Nikita Wilson",23,23,0,1,23,"1.3"
"188.881","Othell Wilson",23,25,2,3,23,"Did Not Play (other pro league—USBL)"
"188.884","Rick Wilson",22,23,1,1,22,"3"
"188.887","Ricky Wilson",23,23,0,3,23,"5.8"
"188.890","Stephen Wilson",22,23,1,1,22,"3.4"
"188.893","Trevor Wilson",22,27,5,6,25,"Did Not Play (other pro league—Spain)"
"188.896","Kyle Wiltjer",24,24,0,1,24,"0.9"
"188.899","Kennard Winchester",24,26,2,3,24,"3.7"
"188.903","Tony Windis",27,27,0,1,27,"4"
"188.906","John Windsor",23,23,0,1,23,"2.5"
"188.909","Lee Winfield",22,28,6,3,24,"10.6"
"188.912","David Wingate",23,37,14,6,24,"8.9"
"188.915","Dontonio Wingfield",20,23,3,2,22,"4.5"
"188.918","Harthorne Wingo",25,28,3,1,27,"7.4"
"188.921","Marv Winkler",22,23,1,2,22,"2.7"
"188.924","Justise Winslow",19,21,2,1,20,"10.9"
"188.927","Rickie Winslow",23,23,0,1,23,"1"
"188.930","Trevor Winter",25,25,0,1,25,"0"
"188.933","Brian Winters",22,30,8,2,25,"19.9"
"188.936","Voise Winters",23,23,0,1,23,"1.5"
"188.939","Skip Wise",20,20,0,1,20,"2"
"188.942","Willie Wise",22,30,8,5,24,"23.2"
"188.945","Jeff Withey",23,27,4,3,25,"4.3"
"188.948","Luke Witte",23,25,2,1,23,"4.5"
"188.951","Greg Wittman",22,23,1,4,22,"3.9"
"188.954","Randy Wittman",24,32,8,4,26,"12.9"
"188.957","Garry Witts",22,22,0,1,22,"2.9"
"188.960","Dave Wohl",22,28,6,7,23,"8.8"
"188.963","Joe Wolf",23,34,11,9,23,"Did Not Play (other pro league—Spain)"
"188.966","Ruben Wolkowyski",27,29,2,3,27,"Did Not Play (other pro league—Russia)"
"188.968","Nate Wolters",22,26,4,5,22,"Did Not Play"
"188.971","Al Wood",23,28,5,5,26,"15"
"188.974","Bob Wood",28,28,0,1,28,"1.2"
"188.977","Christian Wood",20,21,1,2,20,"3.6"
"188.980","David Wood",24,32,8,10,30,"Did Not Play (other pro league—Spain)"
"188.983","Howard Wood",22,22,0,1,22,"3.4"
"188.986","Leon Wood",22,28,6,8,23,"Did Not Play (other pro league—Spain)"
"188.990","Loren Woods",23,29,6,5,26,"Did Not Play (other pro league—Lithuania)"
"188.994","Qyntel Woods",21,24,3,3,24,"6.7"
"188.997","Randy Woods",22,25,3,2,23,"3.6"
"188.1000","Tommy Woods",24,24,0,1,24,"2.3"
"188.1003","Mike Woodson",22,32,10,8,24,"18.2"
"188.1006","Bob Woollard",29,29,0,1,29,"4.4"
"188.1009","Orlando Woolridge",22,34,12,8,31,"25.1"
"188.1012","Haywoode Workman",24,34,10,8,25,"Did Not Play (other pro league—Italy)"
"188.1016","Mark Workman",22,23,1,4,22,"5.3"
"188.1019","Tom Workman",23,26,3,7,25,"11.9"
"188.1025","Willie Worsley",23,23,0,1,23,"6"
"188.1028","Sam Worthen",23,24,1,2,23,"3.7"
"188.1031","James Worthy",21,32,11,1,29,"21.4"
"188.1034","Antoine Wright",21,26,5,5,23,"7.3"
"188.1037","Bracey Wright",21,22,1,1,21,"8.9"
"188.1040","Brad Wright",24,25,1,2,24,"3.7"
"188.1043","Brandan Wright",20,30,10,9,26,"Did Not Play (injury—shoulder)"
"188.1046","Chris Wright",23,25,2,3,25,"Did Not Play"
"188.1049","Chris Wright",23,23,0,1,23,"0.7"
"188.1052","Delon Wright",23,25,2,1,25,"8"
"188.1055","Dorell Wright",19,29,10,4,25,"16.4"
"188.1057","Howard Wright",23,25,2,5,23,"Did Not Play (other pro league—CBA)"
"188.1060","Howie Wright",23,24,1,1,23,"4.6"
"188.1063","Joby Wright",22,25,3,6,25,"Did Not Play"
"188.1066","Julian Wright",20,23,3,2,21,"4.4"
"188.1069","Larry Wright",22,27,5,2,24,"9.3"
"188.1072","Leroy Wright",29,30,1,2,29,"3.4"
"188.1075","Lonnie Wright",23,27,4,3,24,"16.4"
"188.1078","Lorenzen Wright",21,33,12,6,25,"12.4"
"188.1081","Luther Wright",22,22,0,1,22,"1.3"
"188.1084","Sharone Wright",22,25,3,3,23,"16.5"
"188.1087","Tony Wroten",19,22,3,2,21,"16.9"
"188.1090","Dennis Wuycik",22,24,2,2,23,"4.7"
"188.1093","A.J. Wynder",26,26,0,1,26,"2"
"195.36","Guerschon Yabusele",22,22,0,1,22,"2.4"
"195.38","Vincent Yarbrough",21,21,0,1,21,"6.9"
"195.41","George Yardley",25,31,6,4,29,"27.8"
"195.44","Barry Yates",26,26,0,1,26,"2.9"
"195.47","Wayne Yates",24,24,0,1,24,"1.9"
"195.50","Charlie Yelverton",23,23,0,1,23,"7.9"
"195.53","Rich Yonakor",23,23,0,1,23,"3.3"
"195.56","Danny Young",22,32,10,7,23,"Did Not Play (other pro league—France)"
"195.59","James Young",19,22,3,2,19,"3.4"
"195.62","Joe Young",23,25,2,1,25,"3.9"
"195.66","Korleone Young",20,20,0,1,20,"4.3"
"195.68","Michael Young",24,29,5,6,29,"Did Not Play (other pro league—Spain)"
"195.71","Nick Young",22,32,10,6,28,"17.9"
"195.74","Perry Young",23,23,0,3,23,"2"
"195.77","Sam Young",24,27,3,4,24,"7.4"
"195.80","Thaddeus Young",19,29,10,5,25,"17.9"
"195.83","Tim Young",23,23,0,1,23,"2.2"
"195.86","Sun Yue",23,23,0,1,23,"0.6"
"202.36","Max Zaslofsky",21,30,9,6,22,"21"
"202.39","Zeke Zawoluk",22,24,2,2,23,"8.3"
"202.42","Cody Zeller",21,25,4,2,24,"10.3"
"202.45","Dave Zeller",22,22,0,1,22,"1.5"
"202.48","Gary Zeller",23,24,1,3,24,"6.7"
"202.51","Harry Zeller",27,27,0,1,27,"7.5"
"202.54","Luke Zeller",25,25,0,1,25,"1.2"
"202.57","Tyler Zeller",23,28,5,5,25,"10.2"
"202.60","Tony Zeno",22,22,0,1,22,"1.8"
"202.63","Phil Zevenbergen",23,23,0,1,23,"3.8"
"202.67","Wang Zhizhi",23,27,4,4,24,"5.6"
"202.69","George Zidek",22,24,2,4,22,"4"
"202.72","Derrick Zimmerman",24,24,0,1,24,"2"
"202.75","Stephen Zimmerman",20,20,0,1,20,"1.2"
"202.78","Paul Zipser",22,23,1,1,22,"5.5"
"202.80","Ante Zizic",21,21,0,1,21,"3.7"
"202.82","Jim Zoet",29,29,0,1,29,"0.3"
"202.85","Bill Zopf",22,22,0,1,22,"2.2"
"202.88","Ivica Zubac",19,20,1,1,19,"7.5"
"202.90","Matt Zunic",29,29,0,1,29,"4.9"
